State_Name,Year,Data.DHS Denominator,Data.Number of Firms,Data.Calculated.Net Job Creation,Data.Calculated.Net Job Creation Rate,Data.Calculated.Reallocation Rate,Data.Establishments.Entered,Data.Establishments.Entered Rate,Data.Establishments.Exited,Data.Establishments.Exited Rate,Data.Establishments.Physical Locations,Data.Firm Exits.Count,Data.Firm Exits.Establishment Exit,Data.Firm Exits.Employments,Data.Job Creation.Births,Data.Job Creation.Continuers,Data.Job Creation.Count,Data.Job Creation.Rate,Data.Job Creation.Rate/Births,Data.Job Destruction.Continuers,Data.Job Destruction.Count,Data.Job Destruction.Deaths,Data.Job Destruction.Rate,Data.Job Destruction.Rate/Deaths,Data.Population,Data.Labor.Force.Percentage,Data.Employment.Percentage,Data.Labor.Force,Data.Employment,Data.Unemployment,Data.Unemployment.Rate
Alabama,1978,989063,54619,77557,7.841,27.108,10234,15.955,7501,11.694,65508,5232,5308,27751,69513,142103,211616,21.396,7.028,82769,134059,51290,13.554,5.186,2745083,59.1,55.3,1621598,1517226,104372,6.4
Alabama,1979,1060316,56155,57840,5.455,29.799,9426,14.172,7676,11.541,67388,5563,5624,31505,67940,147882,215822,20.354,6.408,103792,157982,54190,14.9,5.111,2790583,59.5,55.2,1661114,1541233,119881,7.2
Alabama,1980,1085319,55832,-6652,-0.613,31.081,8490,12.62,8714,12.953,67161,6307,6369,33722,53952,114711,168663,15.54,4.971,119762,175315,55553,16.153,5.119,2829250,59.4,54.1,1679723,1531840,147883,8.8
Alabama,1981,1073916,55303,-9092,-0.847,31.149,8328,12.413,8461,12.612,67023,6261,6350,32090,66163,101096,167259,15.575,6.161,124057,176351,52294,16.421,4.869,2864250,58.9,52.6,1686584,1505947,180637,10.7
Alabama,1982,1058794,53619,-31815,-3.005,29.581,7759,11.686,9136,13.76,65708,6599,6670,38278,57210,99393,156603,14.791,5.403,129285,188418,59133,17.796,5.585,2889583,59.5,51.2,1720073,1479959,240114,14
Alabama,1983,1026636,53737,-38897,-3.789,31.327,8384,12.787,8711,13.286,65404,5575,5707,31736,55459,105346,160805,15.663,5.402,123988,199702,75714,19.452,7.375,2911083,60.3,52,1756534,1513847,242687,13.8
Alabama,1984,1053563,57361,91617,8.696,23.41,10781,15.97,6615,9.799,69592,4899,4954,26575,74584,140350,214934,20.401,7.079,81938,123317,41379,11.705,3.928,2939000,60.8,53.9,1785713,1584171,201542,11.3
Alabama,1985,1146209,58390,35775,3.121,29.27,9893,14.086,8584,12.222,70889,6146,6253,38580,68521,135003,203524,17.756,5.978,100340,167749,67409,14.635,5.881,2969083,60.8,55,1804882,1632415,172467,9.6
Alabama,1986,1186864,59587,48170,4.059,29.577,10417,14.499,8477,11.799,72818,6041,6159,34976,84787,138903,223690,18.847,7.144,115008,175520,60512,14.789,5.098,3001083,61.7,55.8,1852269,1675271,176998,9.6
Alabama,1987,1192841,60926,21154,1.773,33.498,10767,14.599,8906,12.076,74681,6122,6248,38886,84961,135982,220943,18.522,7.123,126538,199789,73251,16.749,6.141,3035833,61.5,56.5,1867330,1714379,152951,8.2
Alabama,1988,1219534,62229,27620,2.265,30.779,10511,13.885,8701,11.494,76604,6002,6103,36409,88656,126646,215302,17.654,7.27,119987,187682,67695,15.39,5.551,3057500,61.3,56.8,1874512,1737931,136581,7.3
Alabama,1989,1266472,63386,69443,5.483,26.488,10519,13.569,8758,11.298,78402,6190,6323,36270,90135,147038,237173,18.727,7.117,107733,167730,59997,13.244,4.737,3072833,61.8,57.5,1899124,1766197,132927,7
Alabama,1990,1329938,64297,51230,3.852,26.402,9992,12.634,8631,10.913,79768,6331,6470,39475,76062,150730,226792,17.053,5.719,116527,175562,59035,13.201,4.439,3072395,62.2,57.9,1910481,1780162,130319,6.8
Alabama,1991,1354944,64042,-13182,-0.973,30.884,9771,12.215,9173,11.467,80294,6321,6482,50344,88849,120382,209231,15.442,6.557,142455,222413,79958,16.415,5.901,3115005,61.8,57.3,1924056,1783395,140661,7.3
Alabama,1992,1358794,64652,7728,0.569,30.12,9452,11.717,8603,10.665,81093,5788,5934,38702,71350,141012,212362,15.629,5.251,134277,204634,70357,15.06,5.178,3151380,62.3,57.6,1962311,1814583,147728,7.5
Alabama,1993,1388261,66339,53046,3.821,24.698,9634,11.758,7939,9.689,82784,5356,5497,31552,67123,157358,224481,16.17,4.835,113919,171435,57516,12.349,4.143,3194255,62.5,58,1996532,1852383,144149,7.2
Alabama,1994,1436272,68253,30481,2.122,26.663,10405,12.394,8241,9.816,85033,5715,5855,36026,80551,141407,221958,15.454,5.608,128391,191477,63086,13.332,4.392,3228880,63,59.1,2033548,1907892,125656,6.2
Alabama,1995,1482729,70189,71687,4.835,23.527,10585,12.269,8087,9.373,87525,5770,5909,34751,84471,161634,246105,16.598,5.697,118029,174418,56389,11.763,3.803,3253839,63.5,59.8,2065988,1944909,121079,5.9
Alabama,1996,1517572,71090,18220,1.201,27.929,10527,11.942,8646,9.809,89088,6278,6394,40533,81417,148726,230143,15.165,5.365,140855,211923,71068,13.965,4.683,3284630,63.7,60.4,2091357,1982621,108736,5.2
Alabama,1997,1540732,71682,20433,1.326,31.78,10734,11.981,9765,10.899,90080,6657,6797,47235,97509,167747,265256,17.216,6.329,153697,244823,91126,15.89,5.914,3310672,64.4,61.2,2132295,2027092,105203,4.9
Alabama,1998,1593594,72242,25559,1.604,27.753,10114,11.142,9370,10.322,91149,6456,6627,40196,83577,163119,246696,15.48,5.245,146829,221137,74308,13.877,4.663,3342047,64.1,61.2,2142084,2046338,95746,4.5
Alabama,1999,1612763,72254,12086,0.749,29.374,9693,10.61,9300,10.18,91550,6276,6438,40454,91240,157714,248954,15.436,5.657,155247,236868,81621,14.687,5.061,3361672,64,60.9,2149868,2048492,101376,4.7
Alabama,2000,1638467,71665,31310,1.911,26.992,9228,10.094,9576,10.475,91245,6448,6666,43186,74301,178137,252438,15.407,4.535,141344,221128,79784,13.496,4.869,3378393,63.6,60.6,2147173,2047731,99442,4.6
Alabama,2001,1630384,70630,-42107,-2.583,28.506,9449,10.386,9956,10.944,90721,6415,6716,50871,94044,138336,232380,14.253,5.768,176688,274487,97799,16.836,5.999,3392313,62.7,59.5,2128027,2017467,110560,5.2
Alabama,2002,1596024,70712,-33332,-2.088,32.155,10211,11.198,9818,10.767,91380,6028,6196,49280,99540,157059,256599,16.077,6.237,195500,289931,94431,18.166,5.917,3404450,62.1,58.4,2112621,1987633,124988,5.9
Alabama,2003,1590594,71016,22045,1.386,29.143,9548,10.422,8970,9.791,91905,5913,5989,34222,77748,176067,253815,15.957,4.888,155145,231770,76625,14.571,4.817,3421469,62.2,58.5,2128668,2001568,127100,6
Alabama,2004,1621093,71875,38002,2.344,26.36,9604,10.39,8535,9.233,92972,5615,5693,35817,81383,170276,251659,15.524,5.02,140683,213657,72974,13.18,4.502,3444085,62.1,58.6,2138306,2018783,119523,5.6
Alabama,2005,1661491,72508,39164,2.357,27.242,9736,10.408,8551,9.141,94135,5688,5794,32227,82730,182749,265479,15.978,4.979,159251,226315,67064,13.621,4.036,3477391,61.6,58.8,2140356,2045234,95122,4.4
Alabama,2006,1697801,73342,32578,1.919,27.74,10781,11.331,8763,9.21,96155,5971,6089,35700,103576,164484,268060,15.789,6.101,162475,235482,73007,13.87,4.3,3522273,61.6,59.1,2170007,2083207,86800,4
Alabama,2007,1715601,74206,1139,0.066,29.85,10843,11.178,9069,9.349,97888,5861,6065,36145,91795,165397,257192,14.991,5.351,173448,256053,82605,14.925,4.815,3557957,61.3,58.8,2180448,2092030,88418,4.1
Alabama,2008,1712565,73363,-6518,-0.381,27.517,9032,9.262,9686,9.932,97192,6429,6620,38784,76377,159243,235620,13.758,4.46,158525,242138,83613,14.139,4.882,3591892,60.6,57.1,2176854,2049579,127275,5.8
Alabama,2009,1661888,71195,-105075,-6.323,20.737,7707,8.015,10222,10.63,94905,6880,7072,37745,64346,107967,172313,10.369,3.872,205288,277388,72100,16.691,4.338,3621410,59.6,53.5,2156593,1938784,217809,10.1
Alabama,2010,1589553,69416,-37037,-2.33,22.465,7484,7.967,9199,9.792,93082,6039,6177,31370,61962,116585,178547,11.233,3.898,155185,215584,60399,13.563,3.8,3690247,59.5,53.4,2197028,1968824,228204,10.4
Alabama,2011,1580276,68356,22432,1.419,23.834,7598,8.212,8698,9.401,91975,5491,5776,27865,54519,156231,210750,13.336,3.45,131081,188318,57237,11.917,3.622,3725085,59.1,53.5,2202337,1991379,210958,9.6
Alabama,2012,1588647,68027,-4104,-0.258,25.794,7800,8.488,7911,8.609,91836,4987,5122,30550,58546,146340,204886,12.897,3.685,149588,208990,59402,13.155,3.739,3745693,58.2,53.4,2178508,2000848,177660,8.2
Alabama,2013,1590860,67637,11355,0.714,22.949,7451,8.131,7800,8.512,91461,4868,4955,29649,54251,139649,193900,12.188,3.41,120928,182545,61617,11.475,3.873,3765926,57.7,53.4,2172102,2012828,159274,7.3
Alabama,2014,1597421,67562,7173,0.449,23.041,7463,8.14,7052,7.691,91894,4518,4639,27196,61847,129358,191205,11.97,3.872,129618,184032,54414,11.521,3.406,3783191,57.2,53.4,2164715,2018705,146010,6.7
Alabama,2015,1619135,67480,36384,2.247,20.099,7808,8.469,7222,7.833,92493,4619,4776,27255,64418,134683,199101,12.297,3.979,111640,162717,51077,10.05,3.155,3799373,56.6,53.2,2152295,2020443,131852,6.1
Alabama,2016,1655181,68138,35946,2.172,19.722,7819,8.395,6496,6.975,93799,4287,4402,24665,65226,133938,199164,12.033,3.941,112467,163218,50751,9.861,3.066,3816953,56.5,53.2,2155729,2029157,126572,5.9
Alabama,2017,1683412,68312,27869,1.656,22.989,7616,8.113,7455,7.941,93958,4540,4670,28823,56915,164456,221371,13.15,3.381,134242,193502,59260,11.495,3.52,3889272,56.7,54.1,2203458,2103873,99585,4.5
Alabama,2018,1711108,68300,21117,1.234,21.936,7015,7.477,7232,7.709,93709,4512,4670,26589,60427,148363,208790,12.202,3.531,136955,187673,50718,10.968,2.964,3911655,57.3,55,2240109,2152270,87839,3.9
Alabama,2019,1743230,68797,38321,2.198,19.047,7750,8.226,6758,7.173,94711,4553,4680,26644,60308,144026,204334,11.722,3.46,117229,166013,48784,9.523,2.798,3935788,57.7,55.9,2271835,2199379,72456,3.2
Alabama,2020,1773070,68426,19287,1.088,20.773,7281,7.692,7402,7.82,94591,4745,4895,28039,53772,149677,203449,11.474,3.033,132238,184162,51924,10.387,2.928,3953488,57.2,53.6,2263144,2118600,144544,6.4
Alabama,2021,1754911,69701,-58596,-3.339,20.896,9004,9.451,7637,8.016,95956,4617,4946,25879,61970,121383,183353,10.448,3.531,189918,241949,52031,13.787,2.965,3974037,56.6,54.7,2249514,2173978,75536,3.4
Alabama,2022,1748929,70747,47225,2.7,23.299,9444,9.788,8348,8.652,97034,5454,5703,32690,63411,187558,250969,14.35,3.626,135054,203744,68690,11.65,3.928,3998226,56.9,55.5,2276362,2218627,57735,2.5
Alaska,1978,108365,7117,-904,-0.834,64.938,1907,23.529,1267,15.632,8425,828,834,8888,14266,20919,35185,32.469,13.165,18532,36089,17557,33.303,16.202,255000,71.4,63.8,182114,162630,19484,10.7
Alaska,1979,108725,7320,1083,0.996,48.399,1645,19.275,1462,17.13,8626,947,957,5465,10301,17093,27394,25.196,9.474,16873,26311,9438,24.2,8.681,258167,71.5,65,184638,167898,16740,9.1
Alaska,1980,107807,7308,-3092,-2.868,42.125,1443,16.728,1436,16.646,8630,967,978,4687,8097,14610,22707,21.063,7.511,15971,25799,9828,23.931,9.116,264000,71.5,64.7,188828,170894,17934,9.5
Alaska,1981,112457,7656,12784,11.368,34.867,1655,18.74,1240,14.041,9039,810,815,4008,11843,20546,32389,28.801,10.531,12404,19605,7201,17.433,6.403,273750,72.3,65.7,198021,179812,18209,9.2
Alaska,1982,125277,8099,10238,8.172,44.198,1841,19.787,1313,14.112,9568,874,884,5661,13293,24630,37923,30.271,10.611,18313,27685,9372,22.099,7.481,292417,73,65.7,213405,192037,21368,10
Alaska,1983,133038,9162,5932,4.459,48.335,2528,24.814,1286,12.623,10809,870,888,6462,17156,20928,38084,28.627,12.896,20469,32152,11683,24.168,8.782,319833,72.1,64.8,230474,207216,23258,10.1
Alaska,1984,141966,10244,8623,6.074,41.518,2629,23.074,1471,12.91,11973,1029,1049,6713,15784,22310,38094,26.833,11.118,19426,29471,10045,20.759,7.076,335667,72.5,65.3,243254,219239,24015,9.9
Alaska,1985,149504,10576,6220,4.16,44.248,2416,19.856,2023,16.626,12364,1500,1514,9938,14404,24892,39296,26.284,9.635,18221,33076,14855,22.124,9.936,343250,72.7,65.5,249601,224970,24631,9.9
Alaska,1986,149165,10571,-7229,-4.846,45.979,2303,18.603,2274,18.369,12394,1627,1656,8962,14616,19676,34292,22.989,9.799,25623,41521,15898,27.836,10.658,349917,72.8,64.7,254814,226558,28256,11.1
Alaska,1987,142745,10001,-6225,-4.361,45.508,1918,15.843,2488,20.552,11821,1722,1763,10106,15532,16948,32480,22.754,10.881,22623,38705,16082,27.115,11.266,345500,72.2,64.9,249574,224237,25337,10.2
Alaska,1988,138325,10012,-2344,-1.695,44.239,1953,16.479,1916,16.167,11870,1227,1257,7210,12451,18146,30597,22.12,9.001,18854,32941,14087,23.814,10.184,347000,72.3,66,250991,229051,21940,8.7
Alaska,1989,141309,10318,8010,5.668,34.21,1936,16.016,1534,12.69,12289,1037,1059,4962,12307,19874,32181,22.774,8.709,15506,24171,8665,17.105,6.132,350000,73.7,68.5,257917,239601,18316,7.1
Alaska,1990,152024,10616,12628,8.307,30.339,1859,14.914,1501,12.042,12644,1045,1080,6719,10976,24713,35689,23.476,7.22,13634,23061,9427,15.169,6.201,371967,72.7,67.4,270484,250825,19659,7.3
Alaska,1991,160311,10817,1304,0.813,37.834,1919,14.926,1476,11.481,13078,984,1006,5839,11630,20000,31630,19.73,7.255,21226,30326,9100,18.917,5.676,381591,72.4,66.4,276211,253192,23019,8.3
Alaska,1992,164863,10983,-1403,-0.851,41.433,1813,13.735,1497,11.341,13358,925,943,5314,10516,23638,34154,20.717,6.379,25880,35557,9677,21.568,5.87,394654,72.6,66.1,286421,261028,25393,8.9
Alaska,1993,164541,11294,1500,0.912,33.943,1733,12.858,1487,11.033,13601,895,932,4440,8537,20888,29425,17.883,5.188,19438,27925,8487,16.971,5.158,403384,72.9,67.2,294093,271230,22863,7.8
Alaska,1994,170318,11656,5971,3.506,32.361,1824,13.226,1465,10.622,13971,920,944,4275,11984,21545,33529,19.686,7.036,19118,27558,8440,16.18,4.955,409114,73.5,67.9,300786,277841,22945,7.6
Alaska,1995,174762,12045,3600,2.06,30.583,1883,13.277,1466,10.337,14391,972,1000,4519,10222,20102,30324,17.352,5.849,18643,26724,8081,15.292,4.624,415593,72.8,67.5,302756,280554,22202,7.3
Alaska,1996,176558,12225,1683,0.953,31.702,1839,12.727,1547,10.706,14596,1007,1027,5396,8680,20989,29669,16.804,4.916,17910,27986,10076,15.851,5.707,420657,73.4,67.9,308564,285659,22905,7.4
Alaska,1997,180758,12426,6122,3.387,33.449,1894,12.893,1640,11.164,14817,1044,1056,4784,10163,26190,36353,20.111,5.622,20607,30231,9624,16.725,5.324,423636,73.7,68.6,312264,290602,21662,6.9
Alaska,1998,192082,12714,8874,4.62,29.228,1912,12.71,1626,10.809,15186,1020,1055,4649,12901,24044,36945,19.234,6.716,19244,28071,8827,14.614,4.595,426700,73.9,69.2,315314,295323,19991,6.3
Alaska,1999,196003,12779,872,0.445,28.537,1725,11.316,1604,10.523,15304,1050,1070,4474,8145,20694,28839,14.714,4.156,20018,27967,7949,14.269,4.056,432679,73.6,68.8,318295,297873,20422,6.4
Alaska,2000,202660,12787,10414,5.139,27.873,1768,11.519,1717,11.187,15374,1113,1148,6094,13522,25136,38658,19.075,6.672,17776,28244,10468,13.937,5.165,436112,73.3,68.7,319777,299590,20187,6.3
Alaska,2001,208803,12729,3329,1.594,31.006,1744,11.383,1758,11.474,15314,1020,1049,5210,10819,24881,35700,17.097,5.181,19142,32371,13229,15.503,6.336,443270,72.6,68,321652,301422,20230,6.3
Alaska,2002,212600,12848,1984,0.933,35.656,2138,13.812,1846,11.926,15625,1037,1050,6584,15678,24208,39886,18.761,7.374,25602,37902,12300,17.828,5.786,452064,72.3,67.1,327054,303560,23494,7.2
Alaska,2003,215239,13075,6115,2.841,31.59,1969,12.479,1648,10.445,15939,953,976,4886,14089,26023,40112,18.636,6.546,23535,33997,10462,15.795,4.861,459947,72.3,66.7,332494,306964,25530,7.7
Alaska,2004,220919,13397,5631,2.549,26.883,1941,12.056,1618,10.05,16261,988,1021,4955,9776,25550,35326,15.99,4.425,18767,29695,10928,13.442,4.947,470999,71.6,66.3,337469,312394,25075,7.4
Alaska,2005,223863,13578,7207,3.219,25.719,1918,11.687,1598,9.737,16571,1021,1051,4915,11207,24788,35995,16.079,5.006,21213,28788,7575,12.86,3.384,480222,71.7,66.7,344157,320273,23884,6.9
Alaska,2006,236491,13812,11391,4.817,25.297,2167,12.902,1714,10.205,17022,1128,1149,5086,11658,29645,41303,17.465,4.93,20899,29912,9013,12.648,3.811,490049,71.2,66.5,348756,325672,23084,6.6
Alaska,2007,243528,13844,2913,1.196,32.696,2039,11.927,1858,10.868,17186,1150,1166,4860,14657,28068,42725,17.544,6.019,30439,39812,9373,16.348,3.849,495920,70.6,66.2,350233,328309,21924,6.3
Alaska,2008,245971,13690,2511,1.021,26.855,1821,10.647,1964,11.483,17032,1197,1210,5007,10139,25400,35539,14.448,4.122,24008,33028,9020,13.428,3.667,501689,70.8,66.2,355298,332364,22934,6.5
Alaska,2009,249547,13576,3829,1.534,28.607,1817,10.653,1872,10.975,17029,1078,1114,4982,12424,27099,39523,15.838,4.979,24733,35694,10961,14.304,4.392,511902,70.2,64.6,359379,330718,28661,8
Alaska,2010,252845,13616,1783,0.705,24.947,1729,10.119,1620,9.481,17142,952,970,3874,8650,24671,33321,13.178,3.421,23563,31538,7975,12.473,3.154,518527,69.8,64.1,361707,332185,29522,8.2
Alaska,2011,253952,13625,894,0.352,24.309,1773,10.287,1585,9.196,17329,959,982,3378,10038,21723,31761,12.507,3.953,23211,30867,7656,12.155,3.015,528560,69,63.6,364599,336312,28287,7.8
Alaska,2012,256398,13734,2869,1.119,26.912,1743,10.025,1648,9.479,17434,884,896,3456,10772,26598,37370,14.575,4.201,26623,34501,7878,13.456,3.073,534987,68.1,63.1,364153,337834,26319,7.2
Alaska,2013,261588,13813,7547,2.885,20.832,1758,10.048,1631,9.322,17560,931,949,3355,9928,24866,34794,13.301,3.795,20005,27247,7242,10.416,2.768,538482,67.5,62.8,363544,338104,25440,7
Alaska,2014,264352,13840,809,0.306,27.605,1764,9.994,1586,8.985,17740,949,956,3926,13138,24158,37296,14.108,4.97,25753,36487,10734,13.802,4.06,540373,67.4,62.9,364281,339704,24577,6.7
Alaska,2015,265730,13924,2154,0.811,25.767,1760,9.872,1579,8.857,17918,940,952,4162,10483,25906,36389,13.694,3.945,24867,34235,9368,12.883,3.525,542685,66.8,62.6,362425,339604,22821,6.3
Alaska,2016,266229,14037,-1897,-0.713,26.008,1855,10.291,1645,9.126,18130,989,1011,6338,12040,22580,34620,13.004,4.522,25614,36517,10903,13.716,4.095,546589,66.2,61.9,362017,338193,23824,6.6
Alaska,2017,262508,13995,-3603,-1.373,26.069,1758,9.712,1799,9.939,18080,1031,1047,5089,8551,25665,34216,13.034,3.257,25172,37819,12647,14.407,4.818,546466,66,61.7,360589,337108,23481,6.5
Alaska,2018,261620,14063,-1086,-0.415,24.01,1654,9.148,1636,9.048,18090,936,946,3538,7275,24133,31408,12.005,2.781,23674,32494,8820,12.42,3.371,545700,65.1,61.2,355499,334068,21431,6
Alaska,2019,262684,14125,2467,0.939,21.467,1662,9.189,1563,8.642,18136,955,970,3689,8564,22098,30662,11.673,3.26,20855,28195,7340,10.733,2.794,544905,64.6,61,352029,332197,19832,5.6
Alaska,2020,264194,14115,524,0.198,22.727,1664,9.179,1670,9.212,18125,1004,1029,5160,8381,22164,30545,11.562,3.172,21827,30021,8194,11.363,3.102,544188,63.7,58.4,346552,317678,28874,8.3
Alaska,2021,258363,14463,-13137,-5.085,21.838,1966,10.763,1689,9.247,18404,1028,1048,3669,7713,20498,28211,10.919,2.985,32268,41348,9080,16.004,3.514,545410,64.5,60.3,351520,329147,22373,6.4
Alaska,2022,254758,14652,6225,2.444,26.993,2016,10.909,1844,9.978,18566,1216,1231,4715,9267,31341,40608,15.94,3.638,21337,34383,13046,13.496,5.121,545923,64.8,62,353692,338729,14963,4.2
Arizona,1978,660732,40625,89002,13.47,31.331,9694,20.553,6146,13.031,48940,4295,4384,25566,73061,119448,192509,29.136,11.058,59918,103507,43589,15.666,6.597,1809083,59.9,56.3,1083594,1019132,64462,5.9
Arizona,1979,752147,42647,88536,11.771,28.179,8996,17.883,6527,12.975,51538,4722,4800,25815,67507,127003,194510,25.861,8.975,65495,105974,40479,14.09,5.382,1908083,60.5,57.5,1154948,1096553,58395,5.1
Arizona,1980,809525,44609,23120,2.856,34.809,9081,17.217,6696,12.695,53937,4776,4843,25951,62634,101380,164014,20.261,7.737,92883,140894,48011,17.405,5.931,1991917,61.9,57.8,1232426,1150950,81476,6.6
Arizona,1981,831986,46254,24072,2.893,32.833,9477,17.211,7133,12.954,56235,5216,5298,28033,66412,94244,160656,19.31,7.982,93457,136584,43127,16.417,5.184,2052500,61.9,58.1,1271333,1192666,78667,6.2
Arizona,1982,845609,47226,3093,0.366,37.055,9571,16.761,7885,13.808,57946,5753,5783,31830,65316,94449,159765,18.893,7.724,108763,156672,47909,18.528,5.666,2118000,63.5,57.2,1344759,1210605,134154,10
Arizona,1983,851959,49225,8813,1.034,39.002,10034,16.967,7691,13.005,60309,5204,5273,30505,67282,107670,174952,20.535,7.897,110882,166139,55257,19.501,6.486,2190667,63.4,57.7,1389857,1263574,126283,9.1
Arizona,1984,910953,53081,106839,11.728,27.848,11400,18.273,7303,11.706,64434,5012,5116,27713,85530,148148,233678,25.652,9.389,78034,126839,48805,13.924,5.358,2268833,63.4,60.3,1438991,1367661,71330,5
Arizona,1985,1019796,56109,110223,10.808,32.371,11941,18.071,8666,13.115,67717,6129,6248,43981,101576,173704,275280,26.994,9.96,95800,165057,69257,16.185,6.791,2352667,63.4,59.3,1490450,1395353,95097,6.4
Arizona,1986,1107203,58504,62383,5.634,36.645,12641,18.204,9194,13.24,71164,6581,6657,44462,111104,154145,265249,23.957,10.035,134524,202866,68342,18.322,6.172,2427250,64.6,60.1,1569107,1458776,110331,7
Arizona,1987,1155432,60467,27507,2.381,40.731,13140,18.088,10190,14.027,74120,7114,7193,51972,122433,140386,262819,22.746,10.596,138656,235312,96656,20.366,8.365,2511000,64.2,60,1612643,1507545,105098,6.5
Arizona,1988,1178267,62014,34551,2.932,38.338,12693,16.849,10493,13.928,76435,7353,7471,50159,113764,146650,260414,22.101,9.655,139419,225863,86444,19.169,7.337,2572083,64.6,60.5,1662698,1556022,106676,6.4
Arizona,1989,1212440,62659,37538,3.096,36.206,12083,15.699,11051,14.358,77481,7676,7851,52312,103738,153287,257025,21.199,8.556,130700,219487,88787,18.103,7.323,2618167,65.3,61.9,1710093,1621078,89015,5.2
Arizona,1990,1243024,63534,23630,1.901,35.418,11743,15.039,10565,13.53,78672,7474,7683,48188,97388,146370,243758,19.61,7.835,142427,220128,77701,17.709,6.251,2777098,64.3,60.9,1785713,1691996,93717,5.2
Arizona,1991,1253084,64079,-3482,-0.278,37.441,11867,14.958,10381,13.085,80081,7174,7379,55640,108920,125664,234584,18.721,8.692,151724,238066,86342,18.998,6.89,2854417,63.4,59.7,1808277,1702715,105562,5.8
Arizona,1992,1258467,64947,17732,1.409,35.67,11178,13.898,10318,12.828,80861,6503,6677,42209,93696,148486,242182,19.244,7.445,142855,224450,81595,17.835,6.484,2954322,63.5,58.7,1875439,1733258,142181,7.6
Arizona,1993,1289608,67053,45655,3.54,31.157,11201,13.717,9597,11.753,82460,6180,6350,40959,83543,163016,246559,19.119,6.478,124725,200904,76179,15.579,5.907,3070311,63.2,59.2,1941133,1817831,123302,6.4
Arizona,1994,1366032,69758,97601,7.145,29.652,12832,15.211,9281,11.002,86135,6434,6599,41546,114246,185881,300127,21.971,8.363,122968,202526,79558,14.826,5.824,3214383,65.5,61.4,2105320,1975000,130320,6.2
Arizona,1995,1456625,72476,86614,5.946,28.236,12982,14.792,9692,11.043,89409,6630,6822,48670,112072,180185,292257,20.064,7.694,126308,205643,79335,14.118,5.446,3347789,66.8,63.3,2236926,2118341,118585,5.3
Arizona,1996,1528623,74366,81625,5.34,27.932,13192,14.566,10046,11.092,92142,6968,7156,49559,110782,184333,295115,19.306,7.247,134740,213490,78750,13.966,5.152,3465028,66,62.4,2287146,2161444,125702,5.5
Arizona,1997,1626115,76534,89672,5.514,34.216,14464,15.441,11461,12.235,95174,7456,7629,51965,142208,225660,367868,22.623,8.745,163775,278196,114421,17.108,7.036,3584266,64.3,61.3,2304915,2198045,106870,4.6
Arizona,1998,1716817,77998,69897,4.071,31.176,12965,13.45,11214,11.633,97271,7404,7590,51453,125803,211708,337511,19.659,7.328,164753,267614,102861,15.588,5.991,3680505,64.9,62.1,2389188,2287247,101941,4.3
Arizona,1999,1782523,79515,67094,3.764,31.577,13838,14.045,11342,11.512,99774,7309,7578,56183,131020,217507,348527,19.552,7.35,173809,281433,107624,15.788,6.038,3767577,65.9,62.9,2482545,2371566,110979,4.5
Arizona,2000,1870916,80416,91289,4.879,30.009,13612,13.5,11608,11.512,101832,7643,7888,51306,130485,241527,372012,19.884,6.974,187120,280723,93603,15.005,5.003,3849206,65.2,62.6,2510611,2410825,99786,4
Arizona,2001,1930754,81606,18872,0.977,34.953,14001,13.647,12541,12.224,103322,7428,7670,52676,136101,220197,356298,18.454,7.049,193195,337426,144231,17.476,7.47,3953194,65.6,62.5,2593664,2470816,122848,4.7
Arizona,2002,1940740,82221,-11176,-0.576,39.906,14858,14.244,13120,12.578,105180,7854,8087,61872,158947,228291,387238,19.953,8.19,262047,398414,136367,20.529,7.027,4064603,66,62,2683502,2518051,165451,6.2
Arizona,2003,1957825,83822,38517,1.967,35.825,14484,13.648,12500,11.778,107120,7818,7945,53642,141103,248106,389209,19.88,7.207,216427,350692,134265,17.912,6.858,4174320,65.4,61.6,2728649,2571097,157552,5.8
Arizona,2004,2011556,86332,71829,3.571,29.961,14854,13.66,11693,10.753,110325,7407,7619,49895,129881,243287,373168,18.551,6.457,180911,301339,120428,14.98,5.987,4304036,64.8,61.6,2788618,2649564,139054,5
Arizona,2005,2106815,89498,115196,5.468,28.206,16331,14.502,11828,10.504,114861,7594,7838,49869,161445,250879,412324,19.571,7.663,195190,297128,101938,14.103,4.838,4465451,64.1,61.1,2862517,2729018,133499,4.7
Arizona,2006,2257533,94814,176694,7.827,25.022,19582,16.507,12040,10.149,122403,8078,8250,54071,175923,283214,459137,20.338,7.793,184938,282443,97505,12.511,4.319,4630001,64.2,61.4,2970679,2843054,127625,4.3
Arizona,2007,2369533,97334,47866,2.02,33.847,18249,14.675,14296,11.496,126332,9160,9334,59396,157338,291531,448869,18.943,6.64,271670,401003,129333,16.923,5.458,4760450,63.4,61,3018805,2905144,113661,3.8
Arizona,2008,2356232,96463,-75343,-3.198,29.991,15946,12.645,16277,12.907,125944,10881,11101,71254,133020,220307,353327,14.995,5.645,296219,428670,132451,18.193,5.621,4868327,63.6,59.9,3095993,2916698,179295,5.8
Arizona,2009,2223221,91518,-197688,-8.892,25.063,13145,10.632,18660,15.092,120881,12240,12465,99591,116973,161631,278604,12.532,5.261,313728,476292,162564,21.424,7.312,4951436,63.2,57.1,3128891,2826426,302465,9.7
Arizona,2010,2094626,88682,-64834,-3.095,27.57,13150,11.011,16101,13.482,117953,10023,10304,52832,114397,174347,288744,13.785,5.461,243722,353578,109856,16.88,5.245,4896820,63.2,56.7,3096316,2777404,318912,10.3
Arizona,2011,2090179,87807,57259,2.739,25.479,13571,11.539,14259,12.124,117261,9007,9265,49268,107598,215937,323535,15.479,5.148,170555,266276,95721,12.739,4.58,4926325,62,56.1,3051937,2763761,288176,9.4
Arizona,2012,2131355,88015,20547,0.964,28.116,12986,11.067,12811,10.918,117431,7778,8003,42670,103348,216828,320176,15.022,4.849,195854,299629,103775,14.058,4.869,5006638,61,55.9,3054343,2799634,254709,8.3
Arizona,2013,2165099,88785,48873,2.257,24.141,13072,11.083,11974,10.152,118493,7360,7452,43411,102450,207764,310214,14.328,4.732,173800,261341,87541,12.071,4.043,5085868,60.3,55.6,3064554,2825341,239213,7.8
Arizona,2014,2219026,89751,55542,2.503,25.927,13424,11.234,11466,9.595,120476,7214,7343,43591,115511,227692,343203,15.466,5.205,200792,287661,86869,12.963,3.915,5178008,60.2,56.1,3118441,2906193,212248,6.8
Arizona,2015,2281526,91074,69973,3.067,23.012,13425,11.064,11683,9.628,122212,7102,7295,41894,113802,218687,332489,14.573,4.988,171211,262516,91305,11.506,4.002,5276145,60.4,56.7,3184445,2990545,193900,6.1
Arizona,2016,2362167,92862,87228,3.693,24.142,13868,11.209,10879,8.793,125216,6869,7073,56976,128768,243593,372361,15.764,5.451,178860,285133,106273,12.071,4.499,5384442,60.4,57.1,3253468,3075851,177617,5.5
Arizona,2017,2430308,94404,67432,2.775,24.3,13880,10.996,11870,9.404,127231,7132,7288,45815,117465,245250,362715,14.925,4.833,191851,295283,103432,12.15,4.256,5341967,60.7,57.7,3240111,3079700,160411,5
Arizona,2018,2508491,96043,89653,3.574,22.036,13588,10.619,12083,9.443,128709,7404,7615,44838,115225,250813,366038,14.592,4.593,184615,276385,91770,11.018,3.658,5434496,61.2,58.3,3325721,3166013,159708,4.8
Arizona,2019,2588470,97680,69007,2.666,22.21,13801,10.637,11752,9.058,130764,7535,7669,51442,118195,238260,356455,13.771,4.566,187720,287448,99728,11.105,3.853,5537789,62,59,3432400,3267548,164852,4.8
Arizona,2020,2643523,98911,24549,0.929,23.107,14135,10.742,12498,9.498,132409,7899,8052,48308,115514,214456,329970,12.482,4.37,213183,305421,92238,11.554,3.489,5655504,61.4,56.6,3471339,3200219,271120,7.8
Arizona,2021,2637822,102522,-36317,-1.377,26.423,16681,12.426,13014,9.695,136073,8204,8419,50217,126397,222099,348496,13.212,4.792,284665,384813,100148,14.588,3.797,5756580,61.2,58.1,3525449,3347264,178185,5.1
Arizona,2022,2705585,105782,171330,6.332,23.68,17569,12.744,13910,10.09,139694,9607,9793,57026,134693,356977,491670,18.172,4.978,202284,320340,118056,11.84,4.363,5856771,61.5,59.1,3599531,3462671,136860,3.8
Arkansas,1978,557026,36662,47284,8.489,24.904,6970,16.963,5130,12.485,42009,3860,3883,17107,41747,74897,116644,20.941,7.495,43106,69360,26254,12.452,4.713,1616250,58.7,55,948231,889143,59088,6.2
Arkansas,1979,592502,37447,24683,4.166,27.408,6187,14.578,5315,12.523,42877,3987,4024,18567,35904,69974,105878,17.87,6.06,54086,81195,27109,13.704,4.575,1646917,59.3,55.5,975825,914622,61203,6.3
Arkansas,1980,606405,37459,207,0.034,31.325,5530,12.888,5492,12.799,42928,4119,4175,17502,31612,63572,95184,15.696,5.213,65309,94977,29668,15.662,4.892,1670167,59.4,54.9,992324,917629,74695,7.5
Arkansas,1981,603364,37099,-3202,-0.531,29.769,5475,12.772,5480,12.784,42865,4077,4116,18588,36712,53097,89809,14.885,6.085,65285,93011,27726,15.415,4.595,1686583,60.6,55.4,1021664,933659,88005,8.6
Arkansas,1982,592452,36497,-19589,-3.306,28.451,5469,12.819,5855,13.724,42469,4259,4290,19926,30780,53498,84278,14.225,5.195,72772,103867,31095,17.532,5.249,1698000,60.1,54.4,1021146,924559,96587,9.5
Arkansas,1983,580899,37172,-1111,-0.191,31.317,5809,13.557,5082,11.86,43213,3612,3660,16467,31257,59704,90961,15.659,5.381,60222,92072,31850,15.85,5.483,1716750,60.4,54.6,1037698,937019,100679,9.7
Arkansas,1984,605790,39278,46843,7.733,23.847,7090,15.988,4911,11.074,45435,3559,3636,16745,40006,79069,119075,19.656,6.604,44560,72232,27672,11.924,4.568,1733750,60.5,55.3,1048337,958944,89393,8.5
Arkansas,1985,637570,39597,17511,2.747,29.981,6228,13.649,5848,12.816,45821,4400,4466,25166,36984,76101,113085,17.737,5.801,55190,95574,40384,14.99,6.334,1747583,60.3,55.2,1054661,965075,89586,8.5
Arkansas,1986,650845,39838,17407,2.675,30.31,6233,13.547,5818,12.645,46219,4306,4378,22445,43371,72672,116043,17.83,6.664,63230,98636,35406,15.155,5.44,1761667,60.9,55.7,1072750,981090,91660,8.5
Arkansas,1987,673318,39907,21878,3.249,29.607,6427,13.853,6094,13.135,46562,4376,4431,24465,45067,76487,121554,18.053,6.693,60653,99676,39023,14.804,5.796,1777333,61.5,56.5,1092648,1003763,88885,8.1
Arkansas,1988,694546,40114,16691,2.403,30.741,6239,13.312,5687,12.134,47145,4013,4061,23802,42550,80896,123446,17.774,6.126,66354,106755,40401,15.37,5.817,1785000,62.1,57.3,1107912,1022652,85260,7.7
Arkansas,1989,711083,40495,20748,2.918,28.411,6002,12.634,5316,11.19,47848,3935,4014,25286,46294,75467,121761,17.123,6.51,61031,101013,39982,14.206,5.623,1790917,62.7,58.3,1123387,1044104,79283,7.1
Arkansas,1990,733955,41308,27099,3.692,26.177,6138,12.687,5093,10.527,48901,3788,3846,20041,44607,78557,123164,16.781,6.078,65126,96065,30939,13.089,4.215,1780613,63.5,59.1,1130225,1052896,77329,6.8
Arkansas,1991,754472,41176,2879,0.382,30.123,6001,12.222,5522,11.246,49341,3954,4004,23904,44345,72169,116514,15.443,5.878,75758,113635,37877,15.062,5.02,1803118,63,58.4,1136108,1053080,83028,7.3
Arkansas,1992,772887,41636,11390,1.474,29.701,5990,12.066,5282,10.64,49998,3586,3661,22081,41480,84687,126167,16.324,5.367,78796,114777,35981,14.85,4.655,1824976,63.5,59.1,1159463,1078224,81239,7
Arkansas,1993,792870,43026,28924,3.648,25.055,6279,12.394,4954,9.779,51323,3424,3481,17902,39576,88674,128250,16.175,4.991,66962,99326,32364,12.527,4.082,1857667,63.2,59.3,1174395,1102476,71919,6.1
Arkansas,1994,822633,44153,28031,3.407,25.77,6580,12.632,5102,9.795,52827,3665,3743,23789,51087,82942,134029,16.293,6.21,65541,105998,40457,12.885,4.918,1885858,64,60.5,1206333,1140711,65622,5.4
Arkansas,1995,857507,45381,44740,5.217,23.565,6739,12.567,5134,9.574,54426,3740,3791,22657,49420,96354,145774,17,5.763,61159,101034,39875,11.782,4.65,1912550,63.9,60.8,1222813,1163345,59468,4.9
Arkansas,1996,881846,45752,14516,1.646,26.006,6423,11.755,5570,10.194,55068,4067,4181,23104,44081,85101,129182,14.649,4.999,79643,114666,35023,13.003,3.972,1938824,63.8,60.5,1237579,1173516,64063,5.2
Arkansas,1997,898023,46010,14000,1.559,29.118,6693,12.1,6204,11.216,55558,4324,4424,24551,51455,93288,144743,16.118,5.73,81483,130743,49260,14.559,5.485,1963265,63.1,59.9,1239502,1176115,63387,5.1
Arkansas,1998,930483,46008,32362,3.478,25.427,6348,11.361,6077,10.876,56011,4236,4336,24829,58826,91831,150657,16.191,6.322,77756,118295,40539,12.713,4.357,1981707,62.8,59.6,1244905,1181961,62944,5.1
Arkansas,1999,948688,46031,3643,0.384,29.14,6259,11.145,6042,10.758,56269,4143,4263,24912,46641,95228,141869,14.954,4.916,82656,138226,55570,14.57,5.858,2004231,62.7,59.9,1256804,1199971,56833,4.5
Arkansas,2000,969458,46134,35618,3.674,23.609,6259,11.078,5865,10.38,56698,3994,4079,23137,45596,104462,150058,15.479,4.703,73357,114440,41083,11.805,4.238,2026044,62.2,59.6,1260507,1207833,52674,4.2
Arkansas,2001,983304,45554,-5579,-0.567,28.743,6117,10.814,6387,11.292,56429,4310,4443,28595,55625,85691,141316,14.372,5.657,95150,146895,51745,14.939,5.262,2039774,61.8,58.9,1261419,1201314,60105,4.8
Arkansas,2002,977379,45985,-18151,-1.857,30.848,6883,12.076,6117,10.732,57380,3902,3994,35390,53861,96890,150751,15.424,5.511,110239,168902,58663,17.281,6.002,2053079,62.2,58.9,1276964,1209006,67958,5.3
Arkansas,2003,973807,46525,9828,1.009,26.94,6510,11.259,5575,9.642,58288,3771,3836,18318,47220,93781,141001,14.479,4.849,88998,131173,42175,13.47,4.331,2068570,62,58.4,1282578,1208583,73995,5.8
Arkansas,2004,986792,47171,14409,1.46,26.308,6282,10.702,5464,9.309,59107,3782,3842,20603,47465,96746,144211,14.614,4.81,84790,129802,45012,13.154,4.561,2087587,62.4,58.9,1302378,1229546,72832,5.6
Arkansas,2005,1002856,47537,16362,1.632,24.366,6429,10.799,5598,9.403,59947,3987,4044,22793,47691,90847,138538,13.814,4.756,83770,122176,38406,12.183,3.83,2112848,63.1,59.8,1333880,1263663,70217,5.3
Arkansas,2006,1026310,47884,30650,2.986,22.586,7101,11.731,5915,9.772,61126,4212,4296,21594,52254,94298,146552,14.28,5.091,80294,115902,35608,11.293,3.47,2142922,62.8,59.5,1346532,1276000,70532,5.2
Arkansas,2007,1033821,48032,-15660,-1.515,27.86,6638,10.81,5991,9.756,61732,4036,4081,23006,50485,93527,144012,13.93,4.883,111635,159672,48037,15.445,4.647,2166219,62.4,59,1350811,1277902,72909,5.4
Arkansas,2008,1018648,47464,-13720,-1.347,24.758,5747,9.349,6198,10.082,61249,4190,4270,22901,42628,83471,126099,12.379,4.185,99694,139819,40125,13.726,3.939,2186304,62.1,58.7,1357716,1284175,73541,5.4
Arkansas,2009,990888,46635,-46365,-4.679,22.485,5427,8.898,6390,10.477,60509,4325,4419,26755,44456,66943,111399,11.242,4.486,110816,157764,46948,15.921,4.738,2203566,61.4,56.7,1353340,1248691,104649,7.7
Arkansas,2010,965201,46136,-7794,-0.808,23.961,5203,8.621,5577,9.241,60163,3679,3787,21628,39974,75660,115634,11.98,4.142,86198,123428,37230,12.788,3.857,2232732,60.6,55.9,1353635,1247059,106576,7.9
Arkansas,2011,968111,45699,13714,1.417,22.697,5277,8.794,5563,9.271,59864,3652,3812,18293,39637,83944,123581,12.765,4.094,78408,109867,31459,11.349,3.25,2254423,60.2,55.5,1357819,1250431,107388,7.9
Arkansas,2012,973522,45640,-3179,-0.327,23.92,5044,8.433,5126,8.57,59771,3295,3373,18659,30231,86202,116433,11.96,3.105,83598,119612,36014,12.287,3.699,2266990,59.5,55.2,1349888,1251883,98005,7.3
Arkansas,2013,973246,45494,1480,0.152,23.617,5193,8.686,5184,8.671,59791,3364,3478,20546,36730,79676,116406,11.961,3.774,73133,114926,41793,11.809,4.294,2276882,58.5,54.4,1331609,1237609,94000,7.1
Arkansas,2014,978838,45399,8889,0.908,21.378,4899,8.19,4846,8.101,59847,3228,3287,16442,35708,77808,113516,11.597,3.648,67377,104627,37250,10.689,3.806,2287195,58.1,54.6,1327959,1249766,78193,5.9
Arkansas,2015,990056,45339,12298,1.242,21.662,5123,8.541,4879,8.134,60102,3096,3142,17265,38701,80831,119532,12.073,3.909,71233,107234,36001,10.831,3.636,2299074,58.3,55.4,1339301,1272785,66516,5
Arkansas,2016,1008508,45645,24229,2.402,19.837,5478,9.054,4667,7.713,60912,3122,3167,17444,42292,81968,124260,12.321,4.194,71653,100031,28378,9.919,2.814,2312068,58.1,55.8,1343891,1290430,53461,4
Arkansas,2017,1019895,45761,15226,1.493,23.644,5314,8.698,4932,8.073,61282,3058,3153,18696,42413,93387,135800,13.315,4.159,82427,120574,38147,11.822,3.74,2312545,58.3,56.1,1348088,1297854,50234,3.7
Arkansas,2018,1032979,45869,12520,1.212,21.448,5065,8.255,4872,7.941,61450,3170,3276,19081,36714,86585,123299,11.936,3.554,77918,110779,32861,10.724,3.181,2321285,57.9,55.8,1343862,1294809,49053,3.7
Arkansas,2019,1045745,46133,13228,1.265,20.57,5397,8.742,4853,7.861,62007,3238,3382,21588,42022,78763,120785,11.55,4.018,72425,107557,35132,10.285,3.36,2330750,58.1,56,1353175,1305858,47317,3.5
Arkansas,2020,1054783,46034,-149,-0.014,22.001,5287,8.512,5085,8.187,62213,3356,3408,20332,37252,78778,116030,11,3.532,82405,116179,33774,11.014,3.202,2339264,57.3,53.8,1340557,1257949,82608,6.2
Arkansas,2021,1046784,46712,-18022,-1.722,23.416,6010,9.608,5314,8.495,62903,3289,3549,17286,35297,87260,122557,11.708,3.372,106204,140579,34375,13.43,3.284,2353685,56.5,54.3,1330676,1276933,53743,4
Arkansas,2022,1062061,47093,49694,4.679,22.414,6099,9.665,5676,8.995,63316,3779,3933,19334,45499,123222,168721,15.886,4.284,80046,119027,38981,11.207,3.67,2371804,57.3,55.5,1359540,1315886,43654,3.2
California,1978,7013318,388243,694390,9.901,29.499,82023,18.083,54472,12.009,467356,37519,38051,218539,599310,1129505,1728815,24.65,8.545,618923,1034425,415502,14.749,5.924,16761667,65.1,60.4,10910577,10131743,778834,7.1
California,1979,7721254,411706,668790,8.662,28.445,81219,16.868,55737,11.576,494242,38575,39057,216128,587902,1179038,1766940,22.884,7.614,695617,1098150,402533,14.222,5.213,17214167,65.6,61.5,11288184,10586188,701996,6.2
California,1980,8161137,424697,208761,2.558,33.405,78067,15.553,62502,12.452,509727,44232,44824,251220,580798,991060,1571858,19.26,7.117,904644,1363097,458453,16.702,5.618,17687333,65.6,61.1,11605157,10806362,798795,6.9
California,1981,8359317,433389,177498,2.123,33.516,78356,15.193,65836,12.766,521985,46793,47527,267004,601051,977309,1578360,18.881,7.19,938810,1400862,462052,16.758,5.527,18068500,65.4,60.5,11818415,10939299,879116,7.4
California,1982,8381334,430756,-94344,-1.126,35.605,74190,14.196,73287,14.023,523060,51698,52433,302121,557985,934086,1492071,17.802,6.657,1054782,1586415,531633,18.928,6.343,18426583,66,59.3,12156189,10932263,1223926,10.1
California,1983,8290352,438880,-26016,-0.314,37.816,75787,14.378,67765,12.856,531120,44949,45744,270876,549498,1018028,1567526,18.908,6.628,1040264,1593542,553278,19.222,6.674,18725000,65.7,59.2,12302286,11094344,1207942,9.8
California,1984,8603698,462260,701441,8.153,28.937,85944,15.804,61181,11.25,556198,41972,42725,251192,673662,1272609,1946271,22.621,7.83,770380,1244830,474450,14.469,5.514,19162167,65.8,60.7,12611205,11634051,977154,7.7
California,1985,9145367,476352,381145,4.168,34.173,86848,15.422,72987,12.961,570080,50841,51768,366993,693133,1250652,1943785,21.254,7.579,923628,1562640,639012,17.087,6.987,19644083,66,61.3,12968975,12035026,933949,7.2
California,1986,9467853,490635,340824,3.6,34.851,91837,15.835,71665,12.357,590053,49598,50468,327024,755017,1235609,1990626,21.025,7.975,1075028,1649802,574774,17.425,6.071,20065167,66.5,62,13337468,12436979,900489,6.8
California,1987,9844148,504371,350384,3.559,37.168,95980,16.009,77068,12.855,608977,52987,53998,365739,849230,1330613,2179843,22.144,8.627,1143896,1829459,685563,18.584,6.964,20525167,66.9,63,13740589,12939298,801291,5.8
California,1988,10218504,517114,346816,3.394,36.107,94126,15.213,77083,12.458,627256,53266,54402,374395,814327,1377270,2191597,21.447,7.969,1164558,1844781,680223,18.053,6.657,20983083,67.4,63.8,14135934,13390021,745913,5.3
California,1989,10589867,528251,411412,3.885,32.719,94351,14.845,78193,12.303,643635,54423,55771,367741,770619,1373232,2143851,20.244,7.277,1099017,1732439,633422,16.359,5.981,21459000,67.7,64.3,14537086,13797192,739894,5.1
California,1990,11050861,541648,418182,3.784,31.789,94108,14.428,77021,11.808,660814,55144,56425,384802,783467,1391215,2174682,19.679,7.09,1118112,1756500,638388,15.895,5.777,22598254,67,63.1,15141715,14267872,873843,5.8
California,1991,11033952,539352,-441393,-4,32.669,91998,13.868,85367,12.869,666688,60274,61724,487875,732750,1069594,1802344,16.335,6.641,1484154,2243737,759583,20.335,6.884,22780860,66.4,61.2,15130481,13949676,1180805,7.8
California,1992,10622654,531573,-352102,-3.315,33.751,81781,12.344,88790,13.402,659004,58948,60419,441752,648812,1143829,1792641,16.876,6.108,1339447,2144743,805296,20.19,7.581,23048542,66.4,60.2,15303861,13871386,1432475,9.4
California,1993,10483140,526552,-71530,-0.682,34.327,75764,11.583,85449,13.064,649229,55716,57267,347692,579818,1219449,1799267,17.163,5.531,1196536,1870797,674261,17.846,6.432,23149223,65.9,59.7,15262269,13809100,1453169,9.5
California,1994,10429265,526563,-5890,-0.056,34.658,80357,12.37,81306,12.516,649155,53810,55611,357778,686734,1120539,1807273,17.329,6.585,1155530,1813163,657633,17.385,6.306,23194655,65.8,60.1,15266381,13943532,1322849,8.7
California,1995,10561987,531479,278176,2.634,29.717,82328,12.619,75534,11.577,655821,51351,52975,315069,649788,1197733,1847521,17.492,6.152,1017416,1569345,551929,14.858,5.226,23269337,65.6,60.5,15272582,14068313,1204269,7.9
California,1996,10745703,536656,206505,1.922,31.325,83570,12.709,73868,11.234,662404,50475,52041,332066,661845,1227693,1889538,17.584,6.159,1096482,1683033,586551,15.662,5.458,23453185,65.7,60.8,15399748,14268104,1131644,7.3
California,1997,11067065,542361,364470,3.293,33.521,86804,13.056,82338,12.384,667099,51631,53506,363128,785152,1434221,2219373,20.054,7.094,1123222,1854903,731681,16.761,6.611,23829617,66.3,62.1,15806263,14795185,1011078,6.4
California,1998,11641769,553389,499739,4.293,29.287,84014,12.439,72874,10.79,680955,46815,48030,311419,723182,1481298,2204480,18.936,6.212,1095874,1704741,608867,14.643,5.23,24271632,66.6,62.7,16174071,15213328,960743,5.9
California,1999,12041696,561168,255838,2.125,31.948,84745,12.352,74803,10.903,691064,46909,48453,347715,780296,1399106,2179402,18.099,6.48,1204538,1923564,719026,15.974,5.971,24710730,66.5,63,16444135,15576819,867316,5.3
California,2000,12454238,569052,494307,3.969,29.526,83656,12.011,73208,10.511,701739,46495,48244,320907,756580,1576321,2332901,18.732,6.075,1162471,1838594,676123,14.763,5.429,25116226,67,63.8,16837536,16011619,825917,4.9
California,2001,12807155,574561,234728,1.833,31.473,85815,12.154,77863,11.028,710022,49209,50838,360822,757581,1492516,2250097,17.569,5.915,1271618,2015369,743751,15.736,5.807,25526368,67,63.3,17096428,16160509,935919,5.5
California,2002,12829705,577964,-392035,-3.056,35.764,94957,13.259,86434,12.069,720405,52934,54598,467223,932695,1361532,2294227,17.882,7.27,1786135,2686262,900127,20.938,7.016,25882406,66.6,62.1,17246528,16081472,1165056,6.8
California,2003,12707730,586987,148483,1.168,32.984,90635,12.507,81664,11.269,729152,52424,54125,365082,768328,1475922,2244250,17.661,6.046,1383970,2095767,711797,16.492,5.601,26210571,65.9,61.4,17271899,16081515,1190384,6.9
California,2004,12865796,595699,174155,1.354,30.611,90412,12.317,80896,11.02,738812,52683,54199,374979,729731,1413593,2143324,16.659,5.672,1239548,1969169,729621,15.305,5.671,26503320,65.6,61.5,17374506,16293555,1080951,6.2
California,2005,13065731,606536,171549,1.313,29.362,95404,12.784,80725,10.817,753618,54361,55679,352367,756370,1333351,2089721,15.994,5.789,1281337,1918172,636835,14.681,4.874,26761750,65.5,62,17537931,16593622,944309,5.4
California,2006,13455240,624200,510696,3.796,27.316,105891,13.819,80370,10.488,779034,55842,56906,332063,870190,1478255,2348445,17.454,6.467,1228830,1837749,608919,13.658,4.526,27012671,65.4,62.2,17661179,16797845,863334,4.9
California,2007,13708851,632112,-19145,-0.14,31.795,100799,12.849,89431,11.4,790192,58447,59526,358676,758321,1421033,2179354,15.897,5.532,1464483,2198499,734016,16.037,5.354,27274555,65.7,62.2,17910726,16955400,955326,5.3
California,2008,13590668,625788,-113986,-0.839,29.466,88180,11.2,92972,11.808,784958,62254,63419,388969,661128,1341162,2002290,14.733,4.865,1412911,2116276,703365,15.572,5.175,27606374,65.9,61.1,18179907,16856082,1323825,7.3
California,2009,13165889,609097,-883172,-6.708,23.621,78660,10.116,98855,12.713,767476,64985,66425,405296,587315,967627,1554942,11.81,4.461,1715514,2438114,722600,18.518,5.488,27946731,65.5,57.9,18305953,16193122,2112831,11.5
California,2010,12532960,597796,-387935,-3.095,24.578,77560,10.18,89582,11.758,755879,56559,57909,313517,549576,990592,1540168,12.289,4.385,1321569,1928103,606534,15.384,4.84,28532316,64.4,56.4,18370536,16078454,2292082,12.5
California,2011,12440184,598536,192285,1.546,24.773,82674,10.919,80148,10.585,758449,51274,52623,275182,545908,1187298,1733206,13.932,4.388,999914,1540921,541007,12.387,4.349,28952845,63.6,56,18406756,16220602,2186154,11.9
California,2012,12679312,606946,279100,2.201,25.008,84945,11.141,76693,10.059,766580,47089,48233,270593,557067,1307448,1864515,14.705,4.394,1046799,1585415,538616,12.504,4.248,29295636,63.1,56.5,18484881,16541039,1943842,10.5
California,2013,13027822,612638,432585,3.32,23.681,84408,10.966,77596,10.081,773147,48452,49326,280942,650880,1324232,1975112,15.161,4.996,983210,1542527,559317,11.84,4.293,29626794,62.7,57,18565408,16887864,1677544,9
California,2014,13418033,623550,362728,2.703,24.204,87993,11.277,73992,9.483,787296,47373,48289,270439,649379,1337212,1986591,14.805,4.84,1051056,1623863,572807,12.102,4.269,29962936,62.3,57.6,18676692,17264518,1412174,7.6
California,2015,13842090,633669,466064,3.367,22.503,89470,11.262,75290,9.477,801532,49126,50035,300743,686388,1337116,2023504,14.618,4.959,1015860,1557440,541580,11.251,3.913,30283673,62.2,58.3,18824141,17647409,1176732,6.3
California,2016,14203801,645159,310784,2.188,24.134,91813,11.34,75583,9.335,817769,50251,51237,312980,651489,1373272,2024761,14.255,4.587,1066080,1713977,647897,12.067,4.561,30568839,62.2,58.8,19012017,17965407,1046610,5.5
California,2017,14494578,653357,330649,2.281,25.232,90198,10.965,80471,9.782,827494,51517,52735,331838,674380,1484870,2159250,14.897,4.653,1189070,1828601,639531,12.616,4.412,30804622,62.3,59.3,19185366,18258064,927302,4.8
California,2018,14837003,662246,310405,2.092,23.002,88389,10.632,80308,9.66,835375,52452,53578,318883,643463,1373326,2016789,13.593,4.337,1140545,1706384,565839,11.501,3.814,30963179,62.3,59.7,19289505,18469910,819595,4.2
California,2019,15141990,673146,318378,2.103,22.403,92516,10.99,79513,9.445,848320,54388,55225,308613,664397,1350125,2014522,13.304,4.388,1133689,1696144,562455,11.202,3.715,31056874,62.4,59.9,19385262,18589551,795711,4.1
California,2020,15306099,686171,128546,0.84,24.811,99553,11.632,84451,9.868,863389,57098,58277,345602,758128,1269180,2027308,13.245,4.953,1272539,1898762,626223,12.405,4.091,31126813,60.9,54.7,18958604,17037036,1921568,10.1
California,2021,14924257,684874,-872931,-5.849,24.984,102052,11.841,105019,12.186,860342,63585,64985,347524,641049,1223273,1864322,12.492,4.295,2048703,2737253,688550,18.341,4.614,31018365,61.1,56.6,18956575,17568743,1387832,7.3
California,2022,15003925,718043,1099540,7.328,23.09,119820,13.671,87125,9.94,892820,62603,63864,320469,764233,2067527,2831760,18.873,5.094,1076895,1732220,655325,11.545,4.368,31040583,61.8,59.1,19169341,18348916,820425,4.3
Colorado,1978,870743,55983,110161,12.651,28.28,12596,19.984,8052,12.775,65301,5719,5794,29003,80745,152541,233286,26.792,9.273,72091,123125,51034,14.14,5.861,1994750,67.9,64.1,1354526,1279264,75262,5.6
Colorado,1979,976182,58719,90898,9.312,28.222,11639,17.403,8838,13.215,68280,6334,6408,32875,78630,150016,228646,23.422,8.055,83988,137748,53760,14.111,5.507,2069833,69.3,66.1,1435411,1368793,66618,4.6
Colorado,1980,1039365,60545,32451,3.122,33.203,11382,16.419,9286,13.395,70372,6734,6830,39808,74991,130008,204999,19.723,7.215,106075,172548,66473,16.601,6.396,2127833,70.4,66.3,1497824,1410447,87377,5.8
Colorado,1981,1074304,61937,36147,3.365,34.954,11796,16.526,9634,13.497,72460,7187,7268,43803,89493,134411,223904,20.842,8.33,120766,187757,66991,17.477,6.236,2188500,70.5,66.5,1541823,1454591,87232,5.7
Colorado,1982,1107055,62960,28242,2.551,36.21,12044,16.411,10245,13.959,74291,7449,7518,42107,88337,140338,228675,20.656,7.979,132678,200433,67755,18.105,6.12,2255250,70.7,65.3,1594977,1473118,121859,7.6
Colorado,1983,1112178,64815,-24570,-2.209,36.989,12267,16.274,10170,13.492,76425,7156,7229,41215,77125,128567,205692,18.495,6.935,160209,230262,70053,20.704,6.299,2314917,71.7,66.6,1660125,1542722,117403,7.1
Colorado,1984,1135319,68467,66555,5.862,32.561,13641,17.38,9594,12.224,80509,7037,7122,38808,100327,151064,251391,22.143,8.837,112730,184836,72106,16.281,6.351,2354917,72.4,68.4,1704383,1610984,93399,5.5
Colorado,1985,1188584,69670,37029,3.115,35.673,13276,16.352,11904,14.662,81875,8712,8877,58119,90243,158785,249028,20.952,7.592,122471,211999,89528,17.836,7.532,2386000,71.7,67.4,1710753,1608458,102295,6
Colorado,1986,1210887,70167,9465,0.782,37.954,13275,16.096,12011,14.563,83107,8656,8783,56843,101653,137603,239256,19.759,8.395,141499,229791,88292,18.977,7.292,2415667,70.6,65.3,1705113,1576895,128218,7.5
Colorado,1987,1209838,70157,-16494,-1.363,39.669,13133,15.762,12745,15.296,83517,8874,9065,57512,109859,130109,239968,19.835,9.08,152528,256462,103934,21.198,8.591,2436750,69.9,64.6,1702950,1574773,128177,7.5
Colorado,1988,1200658,70304,2739,0.228,37.526,12761,15.213,12220,14.568,84151,8663,8783,50833,92474,135544,228018,18.991,7.702,133049,225279,92230,18.763,7.682,2446500,69.7,65.3,1706310,1596617,109693,6.4
Colorado,1989,1214949,70806,27341,2.25,33.509,12102,14.331,11544,13.67,84727,8004,8246,51320,88087,142812,230899,19.005,7.25,114472,203558,89086,16.754,7.332,2460417,69.5,65.6,1711102,1614923,96179,5.6
Colorado,1990,1248735,72331,39025,3.125,31.058,11960,13.97,10195,11.908,86495,7230,7389,44846,91312,141631,232943,18.654,7.312,118358,193918,75560,15.529,6.051,2488757,71.2,67.5,1771283,1680761,90522,5.1
Colorado,1991,1277855,73740,20537,1.607,32.271,12648,14.44,10239,11.689,88796,7136,7302,49685,89257,137466,226723,17.742,6.985,126309,206186,79877,16.135,6.251,2542584,70.9,67.2,1802962,1707570,95392,5.3
Colorado,1992,1306413,75409,42316,3.239,31.727,12332,13.763,10455,11.668,90543,6757,6905,43701,94767,154789,249556,19.102,7.254,124293,207240,82947,15.863,6.349,2619814,70.5,66.2,1847634,1734836,112798,6.1
Colorado,1993,1361885,79362,66562,4.887,28.105,13134,14.218,9488,10.271,94200,6204,6337,33094,84495,173444,257939,18.94,6.204,124173,191377,67204,14.052,4.935,2713377,71.1,67.3,1929295,1825687,103608,5.4
Colorado,1994,1430343,83398,61674,4.312,28.647,14428,14.925,9728,10.063,99023,6860,6999,41698,99150,167396,266546,18.635,6.932,130083,204872,74789,14.323,5.229,2806107,72.6,69.5,2036075,1951213,84862,4.2
Colorado,1995,1500245,87264,84711,5.646,28.057,14933,14.739,10284,10.15,103644,7237,7344,44050,111611,183562,295173,19.675,7.44,136722,210462,73740,14.029,4.915,2891171,73.5,70.6,2125533,2040057,85476,4
Colorado,1996,1555247,89459,42488,2.732,32.579,14723,14.053,11624,11.095,106316,7987,8124,48940,119629,176203,295832,19.022,7.692,153873,253344,99471,16.29,6.396,2969567,72.7,69.6,2157862,2067922,89940,4.2
Colorado,1997,1613932,91814,66026,4.091,33.262,15785,14.631,12738,11.807,109410,8412,8565,52064,133866,200577,334443,20.722,8.294,161927,268417,106490,16.631,6.598,3042964,72.8,70.3,2214834,2140315,74519,3.4
Colorado,1998,1710629,94539,94310,5.513,29.122,15621,14.009,12220,10.959,113208,8228,8334,45350,125240,218158,343398,20.074,7.321,162865,249088,86223,14.561,5.04,3111611,74.1,71.4,2304973,2221432,83541,3.6
Colorado,1999,1790488,96481,62989,3.518,32.093,15528,13.548,12726,11.103,116017,8371,8622,52365,134496,215806,350302,19.565,7.512,173311,287313,114002,16.047,6.367,3191591,73.2,71,2337540,2266969,70571,3
Colorado,2000,1874985,98348,96174,5.129,28.538,15582,13.272,12899,10.987,118745,8339,8630,51603,130283,233434,363717,19.398,6.948,172042,267543,95501,14.269,5.093,3264672,72.2,70.3,2358371,2294104,64267,2.7
Colorado,2001,1940052,100140,28060,1.446,34.511,16483,13.733,13921,11.598,121308,8824,9039,55870,142132,220692,362824,18.702,7.326,205716,334764,129048,17.255,6.652,3345497,71.6,68.9,2396012,2304547,91465,3.8
Colorado,2002,1928553,100735,-75496,-3.915,35.242,16619,13.603,15697,12.848,122636,9364,9606,63480,138636,201199,339835,17.621,7.189,277396,415331,137935,21.536,7.152,3405964,71.9,67.8,2448903,2309639,139264,5.7
Colorado,2003,1881301,102348,-17832,-0.948,33.416,16616,13.456,14821,12.002,124381,9225,9373,56139,121866,192460,314326,16.708,6.478,212488,332158,119670,17.656,6.361,3451821,72.1,67.7,2490397,2338432,151965,6.1
Colorado,2004,1881603,104213,22550,1.198,29.999,16648,13.261,14340,11.423,126695,9212,9358,52433,115858,188919,304777,16.198,6.157,178937,282227,103290,14.999,5.489,3491060,72.7,68.7,2539389,2397588,141801,5.6
Colorado,2005,1904840,106959,17108,0.898,29.505,17649,13.748,14330,11.163,130035,9265,9415,50258,113228,184892,298120,15.651,5.944,183407,281012,97605,14.753,5.124,3548120,72.5,68.8,2572382,2442134,130248,5.1
Colorado,2006,1957366,110052,84326,4.308,26.956,19386,14.656,14919,11.279,134509,9821,9964,51673,138355,209784,348139,17.786,7.068,167683,263813,96130,13.478,4.911,3621632,72.9,69.8,2640452,2528550,111902,4.2
Colorado,2007,2021181,112056,34982,1.731,31.823,18953,13.94,15973,11.748,137450,10227,10337,54494,132931,223653,356584,17.642,6.577,208441,321602,113161,15.912,5.599,3693148,72.8,70.1,2687742,2588340,99402,3.7
Colorado,2008,2049582,111793,21193,1.034,29.93,16830,12.244,16627,12.096,137561,10854,11007,58287,113464,214452,327916,15.999,5.536,196600,306723,110123,14.965,5.373,3767281,72.6,69.1,2734398,2601712,132686,4.9
Colorado,2009,2010236,108730,-111373,-5.54,24.838,14692,10.782,18315,13.441,134452,11620,11833,60370,101990,147665,249655,12.419,5.074,251156,361028,109872,17.959,5.466,3838336,71.1,65.5,2730604,2515483,215121,7.9
Colorado,2010,1935345,106737,-43340,-2.239,27.071,14902,11.165,16939,12.691,132458,10337,10528,49450,98600,163359,261959,13.536,5.095,208680,305299,96619,15.775,4.992,3869708,70.2,63.8,2715723,2466996,248727,9.2
Colorado,2011,1924682,106428,19670,1.022,26.66,15332,11.572,15259,11.517,132532,9464,9615,44928,90476,185751,276227,14.352,4.701,171740,256557,84817,13.33,4.407,3925294,69.6,63.5,2730262,2493472,236790,8.7
Colorado,2012,1962787,107437,55792,2.842,24.244,15121,11.371,14177,10.661,133446,8434,8624,42475,94638,199085,293723,14.965,4.822,154556,237931,83375,12.122,4.248,3993645,68.8,63.3,2749192,2529785,219407,8
Colorado,2013,2018944,109006,55199,2.734,24.172,15531,11.564,13755,10.242,135192,8380,8469,44061,94471,204740,299211,14.82,4.679,157132,244012,86880,12.086,4.303,4064989,68,63.5,2766140,2579568,186572,6.7
Colorado,2014,2080754,111036,70475,3.387,23.69,16085,11.773,13259,9.705,138035,8423,8496,41280,107201,209737,316938,15.232,5.152,163225,246463,83238,11.845,4,4142393,67.6,64.2,2800666,2661070,139596,5
Colorado,2015,2151995,113255,87799,4.08,22.829,16767,12.022,13867,9.943,140914,8677,8778,45728,112819,220620,333439,15.494,5.243,157525,245640,88115,11.415,4.095,4233776,66.7,64.2,2825761,2719997,105764,3.7
Colorado,2016,2225646,115859,58148,2.613,23.432,17566,12.291,13558,9.486,144924,8659,8808,47920,117523,201380,318903,14.329,5.28,175287,260755,85468,11.716,3.84,4322568,67,64.9,2894157,2803504,90653,3.1
Colorado,2017,2282380,118109,53771,2.356,25.625,17117,11.705,14477,9.9,147551,8848,8987,49877,123347,222858,346205,15.169,5.404,184063,292434,108371,12.813,4.748,4376946,67.7,65.9,2963790,2885980,77810,2.6
Colorado,2018,2332943,120332,46027,1.973,23.975,16783,11.296,14678,9.879,149630,9193,9358,51568,108871,216813,325684,13.96,4.667,183809,279657,95848,11.987,4.108,4451642,68.6,66.5,3054347,2961423,92924,3
Colorado,2019,2384230,121979,58562,2.456,22.685,17297,11.474,15039,9.976,151876,9989,10078,55202,114366,214633,328999,13.799,4.797,176946,270437,93491,11.343,3.921,4519715,68.7,66.9,3104684,3022060,82624,2.7
Colorado,2020,2426674,122370,21901,0.903,25.34,17172,11.274,16318,10.714,152736,10230,10386,56914,111752,217607,329359,13.572,4.605,205616,307458,101842,12.67,4.197,4579850,67.3,62.7,3082228,2873752,208476,6.8
Colorado,2021,2394664,125853,-88609,-3.7,26.65,19687,12.75,16324,10.572,156092,10399,10641,57906,117449,201641,319090,13.325,4.905,299224,407699,108475,17.025,4.53,4625003,68.1,64.4,3149673,2977479,172194,5.5
Colorado,2022,2411999,127507,124231,5.151,25.168,19704,12.546,17720,11.283,158041,12622,12862,61770,129963,297793,427756,17.735,5.388,189508,303525,114017,12.584,4.727,4671612,68.2,66.1,3186932,3089081,97851,3.1
Connecticut,1978,1147727,56267,56706,4.941,24.273,7841,12.422,5674,8.989,64206,3957,3987,20214,51688,144310,195998,17.077,4.504,96265,139292,43027,12.136,3.749,2312833,65.4,61.9,1512462,1432270,80192,5.3
Connecticut,1979,1216900,58371,78583,6.458,19.939,7630,11.664,5497,8.403,66482,3750,3769,20733,57903,141999,199902,16.427,4.758,78428,121319,42891,9.97,3.525,2339167,66.8,63.4,1563642,1484171,79471,5.1
Connecticut,1980,1273807,59207,30736,2.413,23.386,7323,10.923,6279,9.366,67562,4462,4516,20927,54801,124880,179681,14.106,4.302,101929,148945,47016,11.693,3.691,2368167,66.9,63.2,1585339,1495513,89826,5.7
Connecticut,1981,1294007,59683,12106,0.936,25.423,7360,10.838,6586,9.698,68298,4657,4711,22405,66130,110463,176593,13.647,5.11,111204,164487,53283,12.711,4.118,2396750,66.8,62.6,1600049,1500819,99230,6.2
Connecticut,1982,1296680,59561,-9963,-0.768,26.778,7251,10.604,7091,10.37,68462,5031,5106,25661,53246,120367,173613,13.389,4.106,133507,183576,50069,14.157,3.861,2416583,66.7,62.1,1611073,1500673,110400,6.9
Connecticut,1983,1292628,60784,4783,0.37,27.51,8022,11.605,6535,9.454,69871,4520,4564,21965,57811,124773,182584,14.125,4.472,128796,177801,49005,13.755,3.791,2432000,66.6,62.6,1620319,1523137,97182,6
Connecticut,1984,1327126,63527,71804,5.41,22.323,8907,12.485,5972,8.371,72809,4269,4325,24366,67826,152107,219933,16.572,5.111,100578,148129,47551,11.162,3.583,2451083,68.1,64.9,1669603,1591817,77786,4.7
Connecticut,1985,1386789,64949,45686,3.294,24.88,9069,12.319,7462,10.136,74419,5456,5517,35461,64796,153408,218204,15.734,4.672,107942,172518,64576,12.44,4.657,2469917,68.9,65.9,1702636,1627790,74846,4.4
Connecticut,1986,1423599,67044,28020,1.968,26.268,9789,12.945,7323,9.684,76852,5177,5246,30775,74983,140015,214998,15.102,5.267,131377,186978,55601,13.134,3.906,2487500,69.7,67.1,1733909,1668866,65043,3.8
Connecticut,1987,1477623,69421,76634,5.186,27.041,11236,14.333,8132,10.373,79946,5830,5872,39808,116522,159892,276414,18.707,7.886,130257,199780,69523,13.52,4.705,2505500,69.7,67.5,1747296,1692307,54989,3.1
Connecticut,1988,1522259,71847,26204,1.721,31.465,11320,13.887,8378,10.278,82986,5925,5982,42974,106677,159016,265693,17.454,7.008,149446,239489,90043,15.732,5.915,2516833,69.4,67.4,1746477,1696173,50304,2.9
Connecticut,1989,1526515,72990,-18864,-1.236,30.324,10748,12.829,9230,11.017,84535,6677,6759,39406,86627,144821,231448,15.162,5.675,145080,250312,105232,16.398,6.894,2515500,70.3,67.8,1768762,1704954,63808,3.6
Connecticut,1990,1502115,72281,-28861,-1.921,27.677,9270,10.989,9644,11.433,84167,7087,7197,41354,72208,135665,207873,13.839,4.807,152415,236734,84319,15.76,5.613,2573504,70.6,67.1,1817089,1727249,89840,4.9
Connecticut,1991,1456290,69638,-54194,-3.721,27.713,8448,10.169,10439,12.565,82084,7476,7608,47049,70968,130825,201793,13.857,4.873,176561,255987,79426,17.578,5.454,2570734,71.1,66.5,1828627,1708890,119737,6.5
Connecticut,1992,1408023,67971,-23306,-1.655,27.137,7947,9.785,9531,11.735,80428,6304,6441,36040,62891,128155,191046,13.568,4.467,146141,214352,68211,15.224,4.844,2558624,71.1,65.9,1818780,1685625,133155,7.3
Connecticut,1993,1393584,68288,-12158,-0.872,28.602,7915,9.843,7916,9.844,80414,5204,5302,26601,58842,140455,199297,14.301,4.222,153818,211455,57637,15.173,4.136,2552264,70.3,65.8,1794548,1678245,116303,6.5
Connecticut,1994,1380244,68661,-16733,-1.212,27.752,8142,10.079,7628,9.443,81036,5305,5410,31409,60173,131350,191523,13.876,4.36,139906,208256,68350,15.088,4.952,2548654,69,65.2,1758522,1660780,97742,5.6
Connecticut,1995,1381847,69668,24442,1.769,25.4,8619,10.559,7375,9.035,82249,5030,5226,27461,76016,123922,199938,14.469,5.501,120514,175496,54982,12.7,3.979,2550795,68.2,64.6,1740557,1648401,92156,5.3
Connecticut,1996,1391447,69450,7839,0.563,27.386,8052,9.808,7642,9.309,82302,5181,5360,31982,76463,121905,198368,14.256,5.495,128950,190529,61579,13.693,4.426,2558852,68.4,64.8,1749240,1658161,91079,5.2
Connecticut,1997,1431284,69470,41383,2.891,28.463,8431,10.238,8365,10.158,82380,5365,5527,35412,80466,164607,245073,17.123,5.622,124877,203690,78813,14.231,5.506,2566658,68.4,65.2,1754598,1672575,82023,4.7
Connecticut,1998,1472882,69754,21799,1.48,27.334,7957,9.606,7647,9.232,82985,4963,5072,27953,75447,147650,223097,15.147,5.122,142150,201298,59148,13.667,4.016,2573215,67.6,65.4,1740279,1683872,56407,3.2
Connecticut,1999,1502061,69608,32737,2.179,25.603,7695,9.261,7582,9.125,83146,4889,5026,29221,71955,153065,225020,14.981,4.79,124014,192283,68269,12.801,4.545,2582772,67.5,65.9,1744020,1701159,42861,2.5
Connecticut,2000,1532890,69721,17984,1.173,25.543,7489,8.993,7357,8.834,83344,4647,4811,28788,68362,145397,213759,13.945,4.46,129008,195775,66767,12.772,4.356,2594807,67.9,66.4,1760697,1723597,37100,2.1
Connecticut,2001,1543146,69189,1597,0.103,27.857,7705,9.256,7770,9.334,83212,4723,4883,27809,78061,138472,216533,14.032,5.059,137630,214936,77306,13.928,5.01,2611577,67,65,1749195,1698594,50601,2.9
Connecticut,2002,1545772,68648,-10243,-0.663,30.619,8326,9.996,8616,10.344,83150,5039,5119,34232,90286,146364,236650,15.31,5.841,167356,246893,79537,15.972,5.145,2632063,67.5,64.5,1776064,1697788,78276,4.4
Connecticut,2003,1541380,68276,-4855,-0.315,28.071,7513,9.066,8012,9.668,82623,4872,4944,28716,67339,149000,216339,14.035,4.369,147064,221194,74130,14.35,4.809,2651472,67.3,63.7,1785737,1688380,97357,5.5
Connecticut,2004,1537869,68831,-2069,-0.135,26.285,8025,9.658,7137,8.59,83532,4567,4622,25942,66472,135644,202116,13.143,4.322,137662,204185,66523,13.277,4.326,2664644,66.7,63.3,1777510,1687121,90389,5.1
Connecticut,2005,1527337,69178,-16357,-1.071,24.044,8222,9.811,7699,9.187,84069,4802,4865,28825,73005,110613,183618,12.022,4.78,131075,199975,68900,13.093,4.511,2677266,67,63.8,1794301,1707935,86366,4.8
Connecticut,2006,1532130,69396,24609,1.606,24.074,8915,10.542,7929,9.376,85058,5407,5511,31267,76632,132400,209032,13.643,5.002,119345,184423,65078,12.037,4.248,2694038,68,65,1831083,1750385,80698,4.4
Connecticut,2007,1534702,68895,-21164,-1.379,27.123,8263,9.713,8198,9.637,85100,5200,5279,31610,74818,133312,208130,13.562,4.875,165495,229294,63799,14.941,4.157,2707895,68.5,65.5,1856008,1773047,82961,4.5
Connecticut,2008,1528995,68097,5493,0.359,27.645,7578,8.933,8069,9.512,84585,5223,5292,27299,69031,147804,216835,14.182,4.515,149965,211342,61377,13.822,4.014,2727282,68.9,65,1878120,1772393,105727,5.6
Connecticut,2009,1495952,66215,-78473,-5.246,19.999,6373,7.614,8643,10.326,82563,5362,5444,33021,49788,99797,149585,9.999,3.328,165439,228058,62619,15.245,4.186,2746833,68.7,63,1888374,1731361,157013,8.3
Connecticut,2010,1441708,65046,-29122,-2.02,21.46,6611,8.066,7859,9.589,81334,4759,4861,25944,51945,102753,154698,10.73,3.603,132920,183820,50900,12.75,3.531,2798201,68.3,61.8,1911289,1728121,183168,9.6
Connecticut,2011,1428940,64180,4683,0.328,21.849,6545,8.087,7383,9.123,80511,4572,4645,22977,49580,111206,160786,11.252,3.47,106306,156103,49797,10.924,3.485,2829089,67.7,61.6,1914449,1741971,172478,9
Connecticut,2012,1445397,64425,27487,1.902,21.526,7061,8.756,6761,8.384,80796,4062,4132,22276,50707,132349,183056,12.665,3.508,107759,155569,47810,10.763,3.308,2845442,66.3,60.8,1887545,1729687,157858,8.4
Connecticut,2013,1460051,64209,2311,0.158,21.635,6931,8.583,6966,8.627,80732,4225,4284,22343,47575,112676,160251,10.976,3.258,109209,157940,48731,10.817,3.338,2856909,65.4,60.2,1867378,1718834,148544,8
Connecticut,2014,1469777,64026,14643,0.996,21.187,6881,8.513,6729,8.325,80908,4172,4213,20187,52951,117390,170341,11.59,3.603,101847,155698,53851,10.593,3.664,2867360,65.9,61.5,1889102,1764118,124984,6.6
Connecticut,2015,1490767,63814,19916,1.336,21.089,6936,8.563,6774,8.363,81078,4163,4223,24551,58804,118308,177112,11.881,3.945,111659,157196,45537,10.545,3.055,2872222,65.9,62.2,1892087,1785788,106299,5.6
Connecticut,2016,1521141,64504,42034,2.763,19.001,7856,9.602,6393,7.814,82544,4118,4164,20277,63245,123303,186548,12.264,4.158,101150,144514,43364,9.5,2.851,2874830,65.9,62.7,1893200,1801390,91810,4.8
Connecticut,2017,1532531,63653,5981,0.39,23.702,6367,7.753,7173,8.734,81721,4252,4344,32264,62074,125527,187601,12.241,4.05,106888,181620,74732,11.851,4.876,2901376,66.3,63.4,1923711,1838833,84878,4.4
Connecticut,2018,1528907,63211,-12768,-0.835,22.433,6635,8.15,7214,8.862,81117,4358,4410,27620,54721,116770,171491,11.217,3.579,119993,184259,64266,12.052,4.203,2909955,66.1,63.6,1923872,1849370,74502,3.9
Connecticut,2019,1534515,63133,23990,1.563,18.646,6672,8.21,6393,7.867,81404,4358,4411,24520,49319,117730,167049,10.886,3.214,98321,143059,44738,9.323,2.915,2913268,66.3,63.9,1931826,1862314,69512,3.6
Connecticut,2020,1547398,62499,1915,0.124,24.044,6798,8.376,7285,8.976,80918,4615,4706,27710,75725,112220,187945,12.146,4.894,127484,186030,58546,12.022,3.784,2906932,64.5,59.3,1874247,1724812,149435,8
Connecticut,2021,1496254,62060,-105482,-7.05,18.361,7354,9.128,8049,9.99,80222,4690,4864,28041,50765,86602,137367,9.181,3.393,189290,242849,53559,16.23,3.58,2922287,63,59,1842166,1724540,117626,6.4
Connecticut,2022,1475269,63110,64058,4.342,19.676,7953,9.862,7075,8.773,81085,4740,4855,24516,57048,152148,209196,14.18,3.867,95733,145138,49405,9.838,3.349,2933727,65.2,62.5,1912008,1833670,78338,4.1
Delaware,1978,216707,9948,8325,3.842,26.69,1493,13.118,1183,10.395,11536,814,826,4705,10115,27130,37245,17.187,4.668,20368,28920,8552,13.345,3.946,434750,63.8,59.3,277228,257615,19613,7.1
Delaware,1979,225152,10339,8296,3.685,21.525,1527,12.978,1123,9.544,11968,751,768,3554,10414,22114,32528,14.447,4.625,16579,24232,7653,10.763,3.399,439167,64.2,59.7,281813,262118,19695,7
Delaware,1980,232444,10382,6114,2.63,22.754,1326,11.072,1294,10.805,11992,931,957,3857,10285,22274,32559,14.007,4.425,19283,26445,7162,11.377,3.081,440167,64.6,59.7,284208,262919,21289,7.5
Delaware,1981,235673,10391,5749,2.439,22.506,1336,11.115,1268,10.549,12054,892,907,3954,11799,20470,32269,13.692,5.007,18803,26520,7717,11.253,3.274,445083,64.7,59.7,287959,265540,22419,7.8
Delaware,1982,239317,10411,1235,0.516,25.564,1353,11.226,1372,11.384,12043,937,947,5061,9398,22426,31824,13.298,3.927,21013,30589,9576,12.782,4.001,450750,65.2,59.8,294074,269439,24635,8.4
Delaware,1983,244517,10819,8210,3.358,24.607,1670,13.605,1219,9.931,12500,801,810,4252,13444,24850,38294,15.661,5.498,21695,30084,8389,12.303,3.431,456000,65,59.8,296295,272913,23382,7.9
Delaware,1984,233807,11189,12627,5.401,24.422,1711,13.468,1307,10.288,12906,883,889,5316,14108,27069,41177,17.612,6.034,18835,28550,9715,12.211,4.155,462917,66.5,62.4,307879,288818,19061,6.2
Delaware,1985,258615,11519,34821,13.464,26.075,1803,13.777,1428,10.911,13275,946,965,5978,36122,32416,68538,26.502,13.968,21274,33717,12443,13.038,4.811,471583,67.1,63.7,316616,300321,16295,5.1
Delaware,1986,280334,12113,7348,2.621,27.988,2050,15.044,1345,9.87,13979,916,929,4790,15360,31218,46578,16.615,5.479,27698,39230,11532,13.994,4.114,480083,67.6,64.8,324432,310861,13571,4.2
Delaware,1987,291154,12522,-19984,-6.864,38.007,2177,15.263,1581,11.085,14561,1073,1082,6733,18705,36625,55330,19.004,6.424,0,75314,14358,25.867,4.931,490333,68,65.9,333239,323140,10099,3
Delaware,1988,287748,13029,14315,4.975,28.451,2216,14.889,1599,10.743,15192,1066,1087,7308,19732,35516,55248,19.2,6.857,26818,40933,14115,14.225,4.905,500500,69.4,67.3,347343,336914,10429,3
Delaware,1989,300534,13600,10034,3.339,28.247,2320,14.9,1577,10.128,15942,1067,1093,7086,19574,32906,52480,17.462,6.513,29912,42446,12534,14.124,4.171,509500,70.2,67.9,357909,346129,11780,3.3
Delaware,1990,311426,14103,8169,2.623,26.128,2267,13.938,1648,10.132,16574,1150,1160,6778,15568,33285,48853,15.687,4.999,27340,40684,13344,13.064,4.285,512095,70.3,67.2,360126,344167,15959,4.4
Delaware,1991,315736,14252,709,0.225,29.276,2300,13.69,1839,10.946,17031,1249,1286,7323,19299,27628,46927,14.863,6.112,34493,46218,11725,14.638,3.714,520991,69.5,65.4,362077,340715,21362,5.9
Delaware,1992,311010,14247,-8767,-2.819,29.955,2182,12.787,2071,12.136,17120,1256,1266,7348,20888,25694,46582,14.978,6.716,34202,55349,21147,17.797,6.799,528653,69.4,65.8,366987,347756,19231,5.2
Delaware,1993,307880,14682,3413,1.109,27.311,2090,12.08,1748,10.103,17473,1058,1076,5358,14262,31194,45456,14.764,4.632,29733,42043,12310,13.656,3.998,537233,70,66.5,375853,357431,18422,4.9
Delaware,1994,312350,14986,2536,0.812,29.462,2234,12.637,1823,10.312,17884,1149,1158,6103,17702,30846,48548,15.543,5.667,32141,46012,13871,14.731,4.441,545062,70.5,67.2,384251,366158,18093,4.7
Delaware,1995,321301,15466,16874,5.252,24.444,2370,13.039,1790,9.848,18466,1172,1196,6683,18433,37710,56143,17.474,5.737,25571,39269,13698,12.222,4.263,555559,69.5,66.5,385976,369540,16436,4.3
Delaware,1996,329538,15638,4123,1.251,27.268,2176,11.759,1842,9.954,18672,1211,1247,6954,19131,29922,49053,14.885,5.805,31169,44930,13761,13.634,4.176,565138,68.8,65.4,388837,369489,19348,5
Delaware,1997,341383,15992,11775,3.449,28.997,2472,13.072,2024,10.703,19134,1276,1292,8446,22799,38472,61271,17.948,6.678,31466,49496,18030,14.499,5.281,573467,68,65.2,389712,374170,15542,4
Delaware,1998,351907,16474,5293,1.504,31.194,2413,12.369,1995,10.226,19718,1224,1239,7724,21186,38993,60179,17.101,6.02,35627,54886,19259,15.597,5.473,581547,68.1,65.7,396044,382131,13913,3.5
Delaware,1999,356719,16868,4814,1.35,29.91,2466,12.366,2042,10.24,20153,1217,1245,8133,23512,34650,58162,16.305,6.591,34802,53348,18546,14.955,5.199,589543,67.9,65.6,400120,387005,13115,3.3
Delaware,2000,368952,17313,19212,5.207,27.35,2683,13.094,2091,10.204,20787,1279,1301,6921,29861,39806,69667,18.882,8.093,32640,50455,17815,13.675,4.829,597082,69.2,66.7,412956,398188,14768,3.6
Delaware,2001,381732,17639,6336,1.66,30.229,2609,12.406,2127,10.114,21271,1283,1321,7941,23024,41008,64032,16.774,6.031,38983,57696,18713,15.114,4.902,604807,69.7,67.2,421563,406517,15046,3.6
Delaware,2002,385792,17557,-1931,-0.501,34.308,2691,12.527,2442,11.368,21606,1393,1444,8868,31701,34478,66179,17.154,8.217,45652,68110,22458,17.655,5.821,613177,68,65.1,417207,399417,17790,4.3
Delaware,2003,383224,17808,-2799,-0.73,26.923,2429,11.171,2109,9.699,21904,1291,1314,7640,17735,33853,51588,13.462,4.628,35237,54387,19150,14.192,4.997,622359,66.8,63.8,415890,397310,18580,4.5
Delaware,2004,387408,18180,10287,2.655,25.907,2619,11.811,2054,9.263,22456,1281,1299,7491,23287,37183,60470,15.609,6.011,30716,50183,19467,12.954,5.025,632720,66.6,63.7,421093,402992,18101,4.3
Delaware,2005,393450,18367,3226,0.82,26.922,2431,10.805,2330,10.356,22549,1350,1368,9379,19021,37167,56188,14.281,4.834,30960,52962,22002,13.461,5.592,644982,67.2,64.2,433375,413828,19547,4.5
Delaware,2006,391316,18408,-4202,-1.074,28.443,2680,11.827,2487,10.976,22756,1659,1695,8649,20364,35287,55651,14.221,5.204,35965,59853,23888,15.295,6.105,657537,67.4,64.8,443228,425995,17233,3.9
Delaware,2007,387559,18165,-3585,-0.925,33.869,2621,11.506,2596,11.396,22792,1519,1524,9862,28549,37083,65632,16.935,7.366,43346,69217,25871,17.86,6.675,668101,66.7,64.2,445306,429203,16103,3.6
Delaware,2008,384817,17887,-862,-0.224,29.816,2297,10.142,2537,11.201,22529,1588,1601,7419,19406,37963,57369,14.908,5.043,41438,58231,16793,15.132,4.364,678154,66.4,63.1,450265,427694,22571,5
Delaware,2009,377212,17415,-17328,-4.594,23.911,2010,9.003,2572,11.52,22046,1554,1590,8034,20836,24261,45097,11.955,5.524,45116,62425,17309,16.549,4.589,686095,63.9,58.6,438383,401718,36665,8.4
Delaware,2010,363867,17190,-9908,-2.723,21.669,1976,9.032,2342,10.705,21695,1351,1375,6105,12332,27092,39424,10.835,3.389,33998,49332,15334,13.558,4.214,700898,62.2,56.8,436196,398388,37808,8.7
Delaware,2011,358589,17065,-1815,-0.506,23.897,2028,9.371,2148,9.926,21581,1288,1312,5699,12404,30442,42846,11.948,3.459,30874,44661,13787,12.455,3.845,711380,62.4,57.7,443971,410229,33742,7.6
Delaware,2012,359221,16937,2938,0.818,25.51,2117,9.81,2133,9.884,21573,1212,1250,6337,16574,32183,48757,13.573,4.614,28932,45819,16887,12.755,4.701,719197,62,57.6,445962,414489,31473,7.1
Delaware,2013,366886,16957,11750,3.203,22.534,2069,9.581,1975,9.146,21641,1144,1156,5956,18202,34885,53087,14.47,4.961,27123,41337,14214,11.267,3.874,727677,61,56.9,443551,414215,29336,6.6
Delaware,2014,379362,17067,12388,3.265,22.29,2053,9.466,1962,9.046,21734,1123,1145,5626,14916,39751,54667,14.41,3.932,25964,42279,16315,11.145,4.301,737067,61.4,58,452712,427400,25312,5.6
Delaware,2015,389564,17254,7285,1.87,23.79,2229,10.19,1991,9.102,21993,1153,1173,6449,17163,36461,53624,13.765,4.406,31210,46339,15129,11.895,3.884,746043,62,59.1,462752,440555,22197,4.8
Delaware,2016,396483,17643,7201,1.816,23.183,2353,10.559,1766,7.925,22578,1118,1137,6348,16059,37101,53160,13.408,4.05,32709,45959,13250,11.592,3.342,754335,62.1,59.3,468808,447640,21168,4.5
Delaware,2017,397915,17731,-2293,-0.576,27.552,2232,9.868,2185,9.661,22641,1298,1317,6221,17754,37063,54817,13.776,4.462,36455,57110,20655,14.352,5.191,764025,62.2,59.4,475214,453949,21265,4.5
Delaware,2018,401490,17969,6973,1.737,22.985,2249,9.89,2012,8.848,22858,1238,1254,6977,17485,35629,53114,13.229,4.355,32145,46141,13996,11.492,3.486,772933,62.1,59.8,480371,462545,17826,3.7
Delaware,2019,410280,18320,10386,2.531,20.923,2292,9.938,1895,8.216,23262,1252,1266,6303,15772,37535,53307,12.993,3.844,26303,42921,16618,10.461,4.05,782769,62.1,59.9,485873,468539,17334,3.6
Delaware,2020,417474,19258,3862,0.925,23.907,3096,13.032,2102,8.848,24254,1351,1362,8110,21988,31777,53765,12.879,5.267,30876,49903,19027,11.954,4.558,793313,61.4,56.8,486701,450325,36376,7.5
Delaware,2021,416152,19983,-8726,-2.097,27.713,3019,12.292,2402,9.78,24870,1487,1532,8755,21876,35789,57665,13.857,5.257,47776,66391,18615,15.954,4.473,805911,61.3,57.9,493627,466623,27004,5.5
Delaware,2022,418403,20647,13180,3.15,28.833,3282,13.042,2634,10.467,25489,1769,1829,14976,26392,47107,73499,17.567,6.308,27795,60319,32524,14.417,7.773,819160,60.7,58.1,497202,475995,21207,4.3
District of Columbia,1978,295583,12708,22343,7.559,28.705,1904,13.157,1660,11.471,14593,1017,1040,5556,16080,48686,64766,21.911,5.44,25977,42423,16446,14.352,5.564,508750,65.3,60.2,332282,306402,25880,7.8
District of Columbia,1979,319496,13062,22705,7.107,20.839,1857,12.54,1510,10.197,14982,1019,1034,6087,13557,42438,55995,17.526,4.243,21433,33290,11857,10.42,3.711,501833,65.6,61.1,329359,306776,22583,6.9
District of Columbia,1980,329881,13152,-4277,-1.297,32.963,1808,12.056,1652,11.016,15075,1122,1138,7004,16543,37827,54370,16.482,5.015,30113,58647,28534,17.778,8.65,491667,65.8,60.9,323360,299357,24003,7.4
District of Columbia,1981,330912,13235,7499,2.266,26.926,1830,12.098,1768,11.688,15157,1212,1224,7436,18512,33538,52050,15.729,5.594,28761,44551,15790,13.463,4.772,488083,63.6,58.1,310500,283539,26961,8.7
District of Columbia,1982,329984,13292,-19582,-5.934,28.169,1985,13.016,1925,12.622,15281,1319,1333,11485,16968,29508,46476,14.084,5.142,48931,66058,17127,20.019,5.19,484583,63.9,57.3,309748,277754,31994,10.3
District of Columbia,1983,323162,13831,3630,1.123,34.747,2229,14.321,1694,10.884,15832,1123,1137,7771,22247,37527,59774,18.497,6.884,39514,56144,16630,17.373,5.146,483083,65.2,58.1,314988,280656,34332,10.9
District of Columbia,1984,333100,14010,16973,5.095,26.558,2190,13.722,1935,12.124,16087,1356,1388,9238,20581,40625,61206,18.375,6.179,28363,44233,15870,13.279,4.764,483000,66.3,60.5,320359,292012,28347,8.8
District of Columbia,1985,353712,13903,23677,6.694,31.38,2080,12.953,2128,13.252,16034,1588,1610,15325,22087,57088,79175,22.384,6.244,30680,55498,24818,15.69,7.016,483417,66.7,61.4,322394,296654,25740,8
District of Columbia,1986,368426,14174,7893,2.142,28.056,2191,13.477,1737,10.685,16484,1206,1220,9877,22738,36838,59576,16.17,6.172,35427,51683,16256,14.028,4.412,479250,67.4,62.5,323086,299294,23792,7.4
District of Columbia,1987,382533,14309,20514,5.363,27.193,2160,13.013,1919,11.561,16719,1268,1288,9853,27401,45124,72525,18.959,7.163,32723,52011,19288,13.596,5.042,473917,69.3,65,328486,307967,20519,6.2
District of Columbia,1988,381280,14460,-13761,-3.609,31.749,2282,13.483,1916,11.321,17108,1288,1297,12224,21028,39499,60527,15.875,5.515,54777,74288,19511,19.484,5.117,465917,70.5,67,328661,312153,16508,5
District of Columbia,1989,380015,14480,10449,2.75,28.654,2208,12.793,1942,11.251,17393,1288,1296,10519,20593,44301,64894,17.077,5.419,31418,54445,23027,14.327,6.059,453583,69.8,66.5,316743,301494,15249,4.8
District of Columbia,1990,394114,14207,3079,0.781,27.451,1960,11.337,2175,12.581,17181,1513,1534,9729,20086,37087,57173,14.507,5.097,36585,54094,17509,13.725,4.443,485446,68.3,64.3,331677,312071,19606,5.9
District of Columbia,1991,390301,14149,-20705,-5.305,24.77,2100,12.236,2090,12.178,17167,1277,1315,11721,18926,29412,48338,12.385,4.849,48584,69043,20459,17.69,5.242,480014,66.7,61.5,319995,295423,24572,7.7
District of Columbia,1992,384063,13996,10501,2.734,29.266,1819,10.642,1898,11.104,17053,1126,1137,8709,0,30680,66700,17.367,0,39583,56199,16616,14.633,4.326,473734,66.9,61.2,317069,289912,27157,8.6
District of Columbia,1993,386598,14053,4439,1.148,26.51,1724,10.144,1842,10.838,16936,993,1013,6217,18473,37210,55683,14.403,4.778,33603,51244,17641,13.255,4.563,470872,66.8,61.2,314324,287993,26331,8.4
District of Columbia,1994,389099,14200,4027,1.035,24.033,1831,10.738,1635,9.588,17150,1061,1095,6783,16656,34127,50783,13.051,4.281,31794,46756,14962,12.016,3.845,464509,66.7,61.4,309634,285026,24608,7.9
District of Columbia,1995,392154,14315,1650,0.421,27.209,1856,10.758,1649,9.558,17356,1044,1069,6944,16702,38299,55001,14.025,4.259,37967,53351,15384,13.605,3.923,457230,65.7,60,300235,274298,25937,8.6
District of Columbia,1996,375141,14304,-19808,-5.28,24.614,1800,10.389,1693,9.772,17379,1072,1103,7221,15963,30205,46168,12.307,4.255,51121,65976,14855,17.587,3.96,453283,64.1,58.7,290648,266160,24488,8.4
District of Columbia,1997,369135,14188,9884,2.678,26.792,1858,10.744,2027,11.721,17209,1168,1225,7254,22080,37253,59333,16.074,5.982,32034,49449,17415,13.396,4.718,450837,63.7,58.6,287313,263995,23318,8.1
District of Columbia,1998,385185,14294,2112,0.548,28.104,1767,10.197,1707,9.851,17358,932,960,7192,18701,37537,56238,14.6,4.855,34497,54126,19629,14.052,5.096,452808,64.8,59.4,293324,268937,24387,8.3
District of Columbia,1999,387547,14272,3434,0.886,27.004,1806,10.395,1771,10.194,17391,968,993,7238,19718,36042,55760,14.388,5.088,30847,52326,21479,13.502,5.542,456862,66.8,62.5,305391,285335,20056,6.6
District of Columbia,2000,396359,14313,12861,3.245,22.359,1750,10.002,1586,9.065,17578,902,908,5752,19068,38103,57171,14.424,4.811,31920,44310,12390,11.179,3.126,458027,67.7,63.8,309977,292299,17678,5.7
District of Columbia,2001,398100,14227,4661,1.171,28.564,1843,10.538,1697,9.703,17562,913,936,7037,22404,39113,61517,15.453,5.628,34959,56856,21897,14.282,5.5,460926,67.5,63.2,311232,291080,20152,6.5
District of Columbia,2002,412763,14554,586,0.142,32.736,2197,12.277,1980,11.064,18004,989,1009,11634,25536,42611,68147,16.51,6.187,43940,67561,23621,16.368,5.723,461676,66.9,62.2,308760,287196,21564,7
District of Columbia,2003,412600,14539,-298,-0.072,26.794,1731,9.632,1785,9.932,17945,940,949,5434,17222,38055,55277,13.397,4.174,37793,55575,17782,13.469,4.31,461085,66.9,62,308454,285997,22457,7.3
District of Columbia,2004,416508,14794,8150,1.957,24.165,2080,11.462,1689,9.308,18342,959,990,6173,20214,38261,58475,14.039,4.853,35053,50325,15272,12.083,3.667,463326,67.7,62.2,313735,288323,25412,8.1
District of Columbia,2005,422561,14910,3667,0.868,24.029,1868,10.13,1676,9.088,18537,904,926,6036,18461,35974,54435,12.882,4.369,36610,50768,14158,12.014,3.351,466613,68.2,63.4,318130,295907,22223,7
District of Columbia,2006,429977,15212,10933,2.543,24.19,2182,11.611,1666,8.865,19050,932,943,6143,20761,42178,62939,14.638,4.828,36991,52006,15015,12.095,3.492,470130,68.2,63.9,320581,300323,20258,6.3
District of Columbia,2007,435219,15291,-388,-0.089,32.367,2117,11.038,1844,9.614,19316,1000,1007,6926,21763,48670,70433,16.183,5,49611,70821,21210,16.272,4.873,473306,69,64.9,326557,307071,19486,6
District of Columbia,2008,438377,15278,7140,1.629,24.286,1988,10.281,1926,9.96,19368,948,974,5013,19125,41247,60372,13.772,4.363,36716,53232,16516,12.143,3.768,477782,70,65.2,334487,311588,22899,6.8
District of Columbia,2009,446901,15231,5151,1.153,25.456,2052,10.527,1939,9.947,19549,1020,1034,6333,19879,42153,62032,13.88,4.448,41843,56881,15038,12.728,3.365,486105,69.6,62.6,338113,304277,33836,10
District of Columbia,2010,460627,15321,421,0.091,24.513,2033,10.335,1803,9.166,19786,971,982,6034,20376,36501,56877,12.348,4.424,41908,56456,14548,12.256,3.158,502917,68.9,62.1,346707,312132,34575,10
District of Columbia,2011,465831,15476,11548,2.479,20.584,1939,9.755,1763,8.87,19965,878,886,5473,16663,42828,59491,12.771,3.577,35477,47943,12466,10.292,2.676,516884,68.1,61.2,352193,316372,35821,10.2
District of Columbia,2012,474947,15613,9681,2.038,23.63,1834,9.191,1837,9.206,19953,853,868,10174,17487,48308,65795,13.853,3.682,37223,56114,18891,11.815,3.977,528147,69.1,62.9,365176,332412,32764,9
District of Columbia,2013,482214,15796,5137,1.065,21.292,2156,10.707,1771,8.795,20328,879,886,6222,19265,37208,56473,11.711,3.995,34339,51336,16997,10.646,3.525,538977,69.4,63.6,374199,342609,31590,8.4
District of Columbia,2014,487804,15948,6971,1.429,21.754,1989,9.723,1733,8.472,20584,925,939,5925,20103,39926,60029,12.306,4.121,38721,53058,14337,10.877,2.939,547902,69.3,64,379678,350415,29263,7.7
District of Columbia,2015,498425,16178,15181,3.046,23.494,2210,10.677,1978,9.556,20814,984,997,7495,27049,46681,73730,14.793,5.427,40133,58549,18416,11.747,3.695,557243,69.7,64.9,388446,361556,26890,6.9
District of Columbia,2016,512108,16430,11861,2.316,20.53,2289,10.826,1639,7.752,21469,968,990,5715,19887,44541,64428,12.581,3.883,40242,52567,12325,10.265,2.407,565140,69.9,65.6,395124,370553,24571,6.2
District of Columbia,2017,521150,16560,6690,1.284,21.612,2011,9.328,1829,8.484,21649,1013,1025,6722,19006,43999,63005,12.09,3.647,35910,56315,20405,10.806,3.915,558148,70.5,66.2,393326,369388,23938,6.1
District of Columbia,2018,531039,16781,13447,2.532,19.275,2023,9.322,1907,8.788,21759,1009,1022,7047,21176,43450,64626,12.17,3.988,34844,51179,16335,9.638,3.076,561591,70.4,66.5,395604,373202,22402,5.7
District of Columbia,2019,533215,16897,-9212,-1.728,20.837,1989,9.099,1789,8.184,21959,1098,1112,8940,19543,36010,55553,10.419,3.665,45454,64765,19311,12.146,3.622,563160,71.1,67.2,400641,378443,22198,5.5
District of Columbia,2020,534560,16894,9917,1.855,20.632,2040,9.278,1988,9.042,22013,1148,1160,8244,22066,42997,65063,12.171,4.128,37996,55146,17150,10.316,3.208,553833,69.7,64.2,386235,355694,30541,7.9
District of Columbia,2021,512230,16807,-54362,-10.613,20.472,2250,10.292,2531,11.577,21722,1261,1301,9510,20283,32149,52432,10.236,3.96,84063,106794,22731,20.849,4.438,545748,69.2,64.5,377737,352029,25708,6.8
District of Columbia,2022,506178,17265,41588,8.216,20.268,2448,11.21,2216,10.148,21953,1180,1205,7361,21459,71424,92883,18.35,4.239,31538,51295,19757,10.134,3.903,548045,70.9,67.5,388387,369952,18435,4.7
Florida,1978,2543861,165272,244346,9.605,31.768,35705,18.616,24750,12.904,197274,17726,18014,99906,240953,407460,648413,25.489,9.472,231389,404067,172678,15.884,6.788,6970583,56.9,53.1,3968971,3701085,267886,6.7
Florida,1979,2784445,175320,222820,8.002,30.479,35661,17.534,24300,11.948,209062,17483,17690,107076,242219,404941,647160,23.242,8.699,252891,424340,171449,15.24,6.157,7279417,57,53.5,4145808,3897939,247869,6
Florida,1980,2958442,184044,125983,4.258,32.257,36163,16.89,26259,12.264,219063,19424,19671,110147,234431,368702,603133,20.387,7.924,303770,477150,173380,16.128,5.861,7609583,56.5,53.1,4301636,4044296,257340,6
Florida,1981,3104610,192148,164824,5.309,31.812,38306,17.079,27531,12.275,229677,20777,21017,107607,271509,387129,658638,21.215,8.745,329927,493814,163887,15.906,5.279,7905583,57.4,53.4,4534762,4225220,309542,6.8
Florida,1982,3197002,194654,6089,0.19,38.135,36863,15.881,32150,13.851,234470,23959,24214,133604,245157,370521,615678,19.258,7.668,406615,609589,202974,19.068,6.349,8156667,57.6,52.7,4700849,4301377,399472,8.5
Florida,1983,3221489,204093,38613,1.199,37.15,40524,16.889,29915,12.467,245249,21406,21702,119645,266519,370491,637010,19.774,8.273,387570,598397,210827,18.575,6.544,8398083,58.3,53.3,4899627,4477870,421757,8.6
Florida,1984,3401571,216312,307986,9.054,28.537,43935,17.415,30260,11.994,259122,22291,22624,121305,307351,485986,793337,23.323,9.036,294901,485351,190450,14.268,5.599,8654750,59.5,55.6,5153096,4813803,339293,6.6
Florida,1985,3663111,224634,218287,5.959,33.533,45849,17.358,35837,13.568,269144,26606,27065,164825,324003,508459,832462,22.726,8.845,361059,614175,253116,16.766,6.91,8910917,59.9,56.3,5339493,5015083,324410,6.1
Florida,1986,3864158,234117,184968,4.787,34.881,48501,17.619,36120,13.121,281468,26561,26944,165030,350860,508029,858889,22.227,9.08,418525,673921,255396,17.44,6.609,9165917,60.9,57.3,5579374,5254017,325357,5.8
Florida,1987,4047730,242386,171565,4.239,37.371,51427,17.891,39406,13.709,293459,28668,29041,185484,421521,506382,927903,22.924,10.414,451934,756338,304404,18.685,7.52,9426000,62.2,58.8,5860506,5543332,317174,5.4
Florida,1988,4237151,251577,191510,4.52,35.287,52540,17.519,40415,13.476,305968,29744,30279,190890,398296,540798,939094,22.163,9.4,447834,747584,299750,17.644,7.074,9660583,62.9,59.6,6074954,5759377,315577,5.2
Florida,1989,4441580,258643,186294,4.194,34.599,50784,16.349,41706,13.426,315167,30116,30832,199846,377514,577154,954668,21.494,8.5,452974,768374,315400,17.3,7.101,9890833,63.3,59.7,6259000,5908010,350990,5.6
Florida,1990,4617645,265556,113324,2.454,34.488,50816,15.889,41610,13.011,324420,31284,32031,193730,373063,536528,909591,19.698,8.079,500523,796267,295744,17.244,6.405,10261029,63.2,59.2,6482725,6078379,404346,6.2
Florida,1991,4629815,265070,-87605,-1.892,36.725,49176,15.104,46233,14.2,327064,33224,34108,225587,378946,471213,850159,18.363,8.185,587945,937764,349819,20.255,7.556,10485655,62.1,57.4,6510989,6014172,496817,7.6
Florida,1992,4577133,268907,7688,0.168,37.605,48320,14.696,44486,13.53,330722,30421,31217,193289,351859,516445,868304,18.97,7.687,510202,860616,350414,18.803,7.656,10689834,62,56.8,6626483,6071410,555073,8.4
Florida,1993,4689648,278461,197382,4.209,32.177,49898,14.897,41328,12.338,339243,29007,29811,178942,356696,595187,951883,20.298,7.606,456520,754501,297981,16.089,6.354,10886513,62.1,57.5,6762182,6262920,499262,7.4
Florida,1994,4898305,285100,192238,3.925,31.099,50240,14.621,42187,12.277,347653,30972,31642,186099,362417,591483,953900,19.474,7.399,468150,761662,293512,15.55,5.992,11107359,62.4,58.4,6935038,6484892,450146,6.5
Florida,1995,5095612,291015,222218,4.361,30.879,50336,14.319,42462,12.079,355479,31248,32099,202501,416920,592035,1008955,19.8,8.182,481949,786737,304788,15.439,5.981,11335039,62.1,58.6,7041153,6645821,395332,5.6
Florida,1996,5243537,294861,131913,2.516,33.625,49995,13.986,43480,12.163,360732,31628,32319,202658,409458,604030,1013488,19.328,7.809,546739,881575,334836,16.813,6.386,11574135,62,58.8,7179271,6801020,378251,5.3
Florida,1997,5405267,297455,139603,2.583,36.207,52429,14.432,47482,13.07,365754,33310,34233,230155,429804,688349,1118153,20.686,7.952,561935,978550,416615,18.104,7.708,11821564,62.5,59.4,7385282,7021725,363557,4.9
Florida,1998,5646538,301650,231059,4.092,32.945,50022,13.539,44794,12.124,372070,30585,31563,199561,451363,709834,1161197,20.565,7.994,542471,930138,387667,16.473,6.866,12056827,62.6,59.8,7549879,7214413,335466,4.4
Florida,1999,5860754,303475,155046,2.645,34.597,50355,13.483,47450,12.705,374935,31255,32256,209838,395921,772957,1168878,19.944,6.755,595655,1013832,418177,17.299,7.135,12281589,62.7,60.2,7702482,7399031,303451,3.9
Florida,2000,6065288,304207,254907,4.203,30.838,48700,12.951,46697,12.419,377024,30779,31657,190542,403998,786127,1190125,19.622,6.661,550625,935218,384593,15.419,6.341,12489280,63.4,61,7917857,7620683,297174,3.8
Florida,2001,6293148,308069,191452,3.042,35.357,51952,13.681,46806,12.326,382313,29526,30442,188833,457459,846541,1304000,20.721,7.269,647608,1112548,464940,17.679,7.388,12730444,63.2,60.4,8048882,7692124,356758,4.4
Florida,2002,6381237,313445,-100074,-1.568,38.204,56630,14.637,48951,12.653,390726,30310,31102,242396,498506,720430,1218936,19.102,7.812,821234,1319010,497776,20.67,7.801,12994202,62,58.9,8050051,7651923,398128,4.9
Florida,2003,6386861,323536,138597,2.17,34.195,59140,14.936,48475,12.243,401286,31906,32447,194837,450179,780424,1230603,19.268,7.049,647687,1092006,444319,17.098,6.957,13247147,61.3,58.6,8123135,7760904,362231,4.5
Florida,2004,6592735,340486,140977,2.138,33.673,66295,16.141,47584,11.585,420076,31813,32564,209982,444407,806566,1250973,18.975,6.741,669697,1109996,440299,16.837,6.679,13558863,61.6,59.2,8347316,8033591,313725,3.8
Florida,2005,6751381,355661,165506,2.451,31.658,68018,15.857,50404,11.751,437757,33431,33953,220184,486332,747862,1234194,18.281,7.203,664975,1068688,403713,15.829,5.98,13894684,62.2,60.5,8647279,8400346,246933,2.9
Florida,2006,7023408,370485,367667,5.235,27.1,71591,16.009,52678,11.78,456648,36465,36999,205709,509957,809397,1319354,18.785,7.261,590897,951687,360790,13.55,5.137,14163723,63,61.5,8927098,8707158,219940,2.5
Florida,2007,7233565,373697,-19159,-0.265,34.207,67874,14.761,61341,13.34,463101,41665,42350,251167,494444,742744,1237188,17.103,6.835,790893,1256347,465454,17.368,6.435,14339230,63.6,61.5,9113604,8813449,300155,3.3
Florida,2008,7161561,361736,-162240,-2.265,30.119,56680,12.395,67955,14.86,451658,47020,47562,242479,409895,668606,1078501,15.06,5.724,800966,1240741,439775,17.325,6.141,14477369,63.2,59.7,9156458,8636212,520246,5.7
Florida,2009,6859164,347359,-479143,-6.985,25.555,52634,11.814,69105,15.512,437271,45285,46081,222165,373003,503414,876417,12.777,5.438,951268,1355560,404292,19.763,5.894,14589442,61.6,55.7,8987789,8127251,860538,9.6
Florida,2010,6570206,344523,-108437,-1.65,29.274,54559,12.527,58280,13.381,433668,37242,37913,182962,355490,606181,961671,14.637,5.411,701465,1070108,368643,16.287,5.611,14940260,61.2,54.6,9147107,8155401,991706,10.8
Florida,2011,6587457,347236,118615,1.801,28.482,57702,13.251,54146,12.434,437235,35142,35898,175131,379620,677127,1056747,16.042,5.763,583448,938132,354684,14.241,5.384,15209663,60.9,54.8,9260348,8334119,926229,10
Florida,2012,6771474,356108,244403,3.609,26.059,58163,13.156,48308,10.927,447045,30430,31182,209515,408664,718021,1126685,16.639,6.035,540337,882282,341945,13.029,5.05,15438001,60.5,55.2,9335727,8529063,806664,8.6
Florida,2013,7023725,362385,183120,2.607,25.274,56038,12.439,48923,10.859,454078,31520,31965,163951,386376,684338,1070714,15.244,5.501,564270,887594,323324,12.637,4.603,15672642,60.1,55.5,9414664,8706060,708604,7.5
Florida,2014,7223457,368517,261719,3.623,24.212,57310,12.505,49008,10.694,462431,31949,32484,171195,404416,731769,1136185,15.729,5.599,559373,874466,315093,12.106,4.362,15947214,59.9,56,9546407,8931440,614967,6.4
Florida,2015,7540789,376767,327464,4.343,22.337,59531,12.724,48753,10.421,473240,31527,32161,180613,408689,760961,1169650,15.511,5.42,513794,842186,328392,11.168,4.355,16266345,59.3,56,9639737,9106772,532965,5.5
Florida,2016,7833394,386201,230139,2.938,23.287,61276,12.756,47046,9.794,487484,31596,32045,174668,410997,731242,1142239,14.582,5.247,571343,912100,340757,11.644,4.35,16616129,59.2,56.3,9841301,9360237,481064,4.9
Florida,2017,7993327,392817,212438,2.658,24.482,58938,12.002,51806,10.55,494615,32994,33535,186955,393080,797837,1190917,14.899,4.918,610551,978479,367928,12.241,4.603,16818377,59.3,56.8,9972990,9544892,428098,4.3
Florida,2018,8191211,399815,231482,2.826,22.663,58234,11.703,51998,10.449,500733,33390,34018,174573,412477,747186,1159663,14.157,5.036,580993,928181,347188,11.331,4.239,17061122,59.3,57.1,10118306,9749598,368708,3.6
Florida,2019,8364786,407818,167086,1.997,21.833,61354,12.129,51120,10.106,510958,35215,35649,183913,392891,687356,1080247,12.914,4.697,591037,913161,322124,10.917,3.851,17273996,59.4,57.4,10256297,9922941,333356,3.3
Florida,2020,8521700,412156,144159,1.692,23.82,62785,12.206,55939,10.875,517803,36366,36865,185818,426552,732540,1159092,13.602,5.005,655854,1014933,359079,11.91,4.214,17484765,57.6,52.9,10077028,9257738,819290,8.1
Florida,2021,8519574,432987,-204980,-2.406,25.819,77041,14.578,55676,10.535,539161,36050,36839,165283,454109,645737,1099846,12.91,5.33,983156,1304826,321670,15.316,3.776,17737009,58.2,55.5,10320373,9838506,481867,4.7
Florida,2022,8556525,445422,504805,5.9,23.632,75778,13.875,61635,11.285,553216,46309,47190,231024,449772,1066093,1515865,17.716,5.256,620387,1011060,390673,11.816,4.566,18084471,59.1,57.3,10692183,10370751,321432,3
Georgia,1978,1572171,82159,144133,9.168,26.012,15648,15.924,11769,11.976,100207,8037,8128,43037,119072,229541,348613,22.174,7.574,124649,204480,79831,13.006,5.078,3732167,64.5,60.9,2408232,2271148,137084,5.7
Georgia,1979,1686475,84915,71333,4.23,28.239,15159,14.832,11599,11.349,103984,8178,8265,44199,109410,200046,309456,18.349,6.487,158384,238123,79739,14.12,4.728,3828667,64.4,61.1,2467346,2341083,126263,5.1
Georgia,1980,1733756,85987,15114,0.872,29.285,13960,13.328,12502,11.936,105471,8852,8955,46332,97702,171274,268976,15.514,5.635,170338,253862,83524,14.642,4.818,3920333,64.6,60.6,2534069,2374644,159425,6.3
Georgia,1981,1763207,86927,47454,2.691,29.455,14554,13.685,12627,11.873,107317,9058,9199,46098,120919,186210,307129,17.419,6.858,178410,259675,81265,14.727,4.609,4010083,64.7,60.5,2593241,2425289,167952,6.5
Georgia,1982,1787901,86324,-5386,-0.301,32.285,13877,12.917,13767,12.814,107491,9652,9775,52659,107772,180836,288608,16.142,6.028,202358,293994,91636,16.444,5.125,4084667,65,59.9,2655367,2448575,206792,7.8
Georgia,1983,1787847,89312,15196,0.85,33.052,15771,14.443,12362,11.321,110898,8286,8410,47761,107159,203495,310654,17.376,5.994,189163,295458,106295,16.526,5.945,4149833,65,60,2696926,2491523,205403,7.6
Georgia,1984,1885677,95306,178325,9.457,23.517,18415,16.113,11783,10.31,117605,8153,8260,46558,142189,257865,400054,21.215,7.54,137803,221729,83926,11.759,4.451,4241083,65.4,61.4,2774347,2605431,168916,6.1
Georgia,1985,2048950,99154,149124,7.278,27.079,18485,15.436,14126,11.796,121935,9845,10025,62925,142876,283665,426541,20.818,6.973,168335,277417,109082,13.539,5.324,4359583,65.9,61.7,2874345,2691885,182460,6.3
Georgia,1986,2179038,102884,106951,4.908,29.506,19841,15.932,14599,11.723,127158,10076,10207,64533,160636,267792,428428,19.661,7.372,208490,321477,112987,14.753,5.185,4449917,66.9,63,2979197,2803495,175702,5.9
Georgia,1987,2289236,105664,85752,3.746,33.725,20325,15.709,15909,12.296,131589,10760,10937,75121,205077,266699,471776,20.608,8.958,243101,386024,142923,16.863,6.243,4553167,67.2,63.4,3057532,2887450,170082,5.6
Georgia,1988,2379462,108973,74889,3.147,32.667,20805,15.512,16066,11.978,136495,11072,11245,81801,193596,269941,463537,19.481,8.136,241086,388648,147562,16.333,6.201,4634833,67.9,64.1,3147975,2971341,176634,5.6
Georgia,1989,2450078,111668,81388,3.322,33.261,20678,14.932,16816,12.143,140415,11560,11826,79097,194852,293995,488847,19.952,7.953,261255,407459,146204,16.63,5.967,4699833,68.3,64.6,3208172,3035117,173055,5.4
Georgia,1990,2522063,113340,59541,2.361,31.352,19415,13.701,16838,11.882,142998,11882,12175,77206,166651,288251,454902,18.037,6.608,255048,395361,140313,15.676,5.563,4873145,67.5,63.9,3290128,3114069,176059,5.4
Georgia,1991,2507261,112724,-92604,-3.693,31.999,19105,13.333,18220,12.716,143730,12398,12725,111288,170254,230901,401155,16,6.79,306425,493759,187334,19.693,7.472,4976618,66.6,63.1,3315973,3140985,174988,5.3
Georgia,1992,2487254,114394,43261,1.739,32.421,19058,13.191,17380,12.03,145315,11011,11412,77799,164064,282388,446452,17.95,6.596,251979,403191,151212,16.21,6.079,5085498,67.3,62.8,3421655,3195577,226078,6.6
Georgia,1993,2556916,118491,97209,3.802,28.009,19387,13.169,15572,10.578,149120,10219,10489,66810,158173,297125,455298,17.807,6.186,230862,358089,127227,14.005,4.976,5201462,67.3,63.5,3501845,3301631,200214,5.7
Georgia,1994,2667630,122168,111997,4.198,27.475,20626,13.606,16109,10.626,153856,11001,11238,74797,178950,299509,478459,17.936,6.708,224147,366462,142315,13.737,5.335,5332009,67.6,64.2,3606992,3424282,182710,5.1
Georgia,1995,2807016,126386,161362,5.749,26.418,21658,13.821,15935,10.169,159570,11025,11301,72096,202025,330117,532142,18.958,7.197,233315,370780,137465,13.209,4.897,5459973,67.6,64.4,3689479,3514203,175276,4.8
Georgia,1996,2913010,129637,93256,3.201,29.384,22303,13.816,17312,10.724,163929,11914,12173,80321,200867,320367,521234,17.893,6.896,270781,427978,157197,14.692,5.396,5591770,68.1,64.9,3806941,3631786,175155,4.6
Georgia,1997,2998499,131907,74616,2.488,33.205,22551,13.615,19251,11.622,167288,12800,13103,92015,210781,361658,572439,19.091,7.03,307929,497823,189894,16.602,6.333,5727317,68.9,65.8,3944461,3768421,176040,4.5
Georgia,1998,3148290,135140,118449,3.762,30.345,23219,13.648,18737,11.013,172374,12125,12513,83692,225391,370729,596120,18.935,7.159,299978,477671,177693,15.172,5.644,5852865,69.2,66.3,4047860,3878294,169566,4.2
Georgia,1999,3267887,137407,118662,3.631,29.374,22230,12.799,19567,11.266,175014,12309,12700,85526,216441,382169,598610,18.318,6.623,300982,479948,178966,14.687,5.477,5974745,69.1,66.5,4129058,3971637,157421,3.8
Georgia,2000,3376045,138496,101280,3,29.751,22263,12.629,19852,11.261,177494,12671,12974,86120,211414,392067,603481,17.875,6.262,321647,502201,180554,14.875,5.348,6094409,69,66.5,4202695,4055366,147329,3.5
Georgia,2001,3434940,139805,-8910,-0.259,32.908,22838,12.79,20737,11.613,179612,12504,13146,95389,218827,346365,565192,16.454,6.371,360676,574102,213426,16.714,6.213,6226566,68.4,65.6,4257901,4083528,174373,4.1
Georgia,2002,3419097,141417,-92099,-2.694,33.158,24275,13.406,22143,12.228,182148,12812,13170,110186,237362,329484,566846,16.579,6.942,425457,658945,233488,19.272,6.829,6350716,68.4,64.7,4341617,4111627,229990,5.3
Georgia,2003,3363210,144250,-15593,-0.464,31.375,23924,13.03,20879,11.372,185128,12789,13096,78250,192922,334683,527605,15.688,5.736,357962,543198,185236,16.151,5.508,6465778,68.3,64.8,4414282,4187003,227279,5.1
Georgia,2004,3393951,148367,68594,2.021,29.041,24166,12.885,19381,10.334,189937,12398,12611,76340,196150,365260,561410,16.541,5.779,320525,492816,172291,14.52,5.076,6589698,67.8,64.3,4464780,4236301,228479,5.1
Georgia,2005,3452850,152031,43820,1.269,29.044,24999,13,20372,10.594,194616,13075,13337,80075,203799,341450,545249,15.791,5.902,329438,501429,171991,14.522,4.981,6747800,68.1,64.3,4598159,4336264,261895,5.7
Georgia,2006,3545080,157025,125947,3.553,26.808,27650,13.958,20693,10.446,201573,13686,13942,83361,232444,368684,601128,16.957,6.557,306276,475181,168905,13.404,4.764,6914799,68.2,64.7,4713863,4474820,239043,5.1
Georgia,2007,3620490,160383,15632,0.432,31.204,27698,13.569,22503,11.024,206730,14512,14913,90918,229774,350735,580509,16.034,6.346,369755,564877,195122,15.602,5.389,7072669,68,64.7,4810264,4573302,236962,4.9
Georgia,2008,3624202,158313,-10357,-0.286,30.847,24016,11.659,25370,12.316,205309,16879,17132,98869,208105,350867,558972,15.423,5.742,366301,569329,203028,15.709,5.602,7197409,67.6,63,4863225,4534790,328435,6.8
Georgia,2009,3517648,151859,-229593,-6.527,24.76,20704,10.229,27906,13.787,198809,18251,18675,111855,186190,249298,435488,12.38,5.293,459812,665081,205269,18.907,5.835,7300589,65.6,58.8,4792150,4292830,499320,10.4
Georgia,2010,3357954,148642,-84355,-2.512,24.008,19832,10.071,23754,12.063,194954,14903,15223,77945,143038,260049,403087,12.004,4.26,329196,487442,158246,14.516,4.713,7322355,64.3,57.5,4709781,4207266,502515,10.7
Georgia,2011,3321994,147433,13955,0.42,26.076,20670,10.626,21538,11.072,194088,13716,14118,75384,150233,296844,447077,13.458,4.522,281566,433122,151556,13.038,4.562,7381037,64.2,57.7,4739281,4258833,480448,10.1
Georgia,2012,3351899,147995,45576,1.36,25.598,21150,10.88,20527,10.56,194702,12309,12546,68440,163199,311387,474586,14.159,4.869,268831,429010,160179,12.799,4.779,7476643,63.8,58,4770618,4339369,431249,9
Georgia,2013,3409387,149042,72273,2.12,23.259,20525,10.508,19173,9.815,196012,11787,11969,68240,142020,326751,468771,13.749,4.166,248833,396498,147665,11.63,4.331,7559402,62.8,57.7,4750046,4363292,386754,8.1
Georgia,2014,3481322,150319,73659,2.116,22.86,21181,10.733,18574,9.412,198650,11756,11972,84386,148227,323350,471577,13.546,4.258,249228,397918,148690,11.43,4.271,7652862,62,57.6,4745859,4407067,338792,7.1
Georgia,2015,3588210,152469,130543,3.638,22.233,21714,10.843,18512,9.244,201864,11466,11762,73011,180212,349223,529435,14.755,5.022,259884,398892,139008,11.117,3.874,7762111,61,57.3,4734088,4446515,287573,6.1
Georgia,2016,3718909,155399,109225,2.937,21.127,22201,10.877,17735,8.689,206340,11368,11633,71941,169810,332255,502065,13.5,4.566,261117,392840,131723,10.563,3.542,7885093,62.4,59,4921814,4653740,268074,5.4
Georgia,2017,3811625,157724,90707,2.38,24.223,21908,10.539,18834,9.061,209406,11724,11987,71127,185986,366375,552361,14.491,4.879,300921,461654,160733,12.112,4.217,7995544,63.9,60.8,5107889,4864813,243076,4.8
Georgia,2018,3910709,159811,84855,2.17,23.372,21333,10.148,19584,9.316,211094,12203,12514,72184,169864,372001,541865,13.856,4.344,305847,457010,151163,11.686,3.865,8097261,63.3,60.8,5126923,4922489,204434,4
Georgia,2019,3994888,162218,79746,1.996,22.703,22361,10.501,18747,8.804,214747,12523,12710,72684,177616,355614,533230,13.348,4.446,298813,453484,154671,11.352,3.872,8203811,63,60.7,5165423,4980501,184922,3.6
Georgia,2020,4071786,163723,64830,1.592,22.655,22739,10.534,20496,9.495,216987,13041,13314,70905,194534,331524,526058,12.92,4.778,318717,461228,142511,11.327,3.5,8286829,61.3,57.4,5082864,4754102,328762,6.5
Georgia,2021,4074622,171823,-69722,-1.711,26.285,28955,13.114,21352,9.671,224593,12802,13279,72376,201776,333731,535507,13.142,4.952,436626,605229,168603,14.854,4.138,8369409,61.6,59.2,5156388,4954094,202294,3.9
Georgia,2022,4110120,175195,189001,4.598,23.648,28378,12.53,24531,10.832,228401,17639,17990,98000,198761,476223,674984,16.422,4.836,304153,485983,181830,11.824,4.424,8484037,61.6,59.6,5222263,5058165,164098,3.1
Hawaii,1978,271280,15728,20352,7.502,30.173,3017,16.371,2064,11.2,18905,1323,1342,7137,24724,36554,61278,22.589,9.114,23733,40926,17193,15.086,6.338,624167,67.5,62.8,421466,392252,29214,6.9
Hawaii,1979,293863,16726,19850,6.755,25.627,3141,16.039,1951,9.963,20178,1343,1363,8061,20786,36718,57504,19.568,7.073,24767,37654,12887,12.813,4.385,644250,66.6,62.8,429077,404493,24584,5.7
Hawaii,1980,308936,17578,9002,2.914,29.162,3123,15.117,2132,10.32,21154,1493,1521,8478,21530,32518,54048,17.495,6.969,30684,45046,14362,14.581,4.649,663083,66.5,63.2,440743,418984,21759,4.9
Hawaii,1981,317463,18056,9117,2.872,30.169,3084,14.38,2464,11.489,21757,1802,1848,9815,23572,33432,57004,17.956,7.425,32846,47887,15041,15.084,4.738,675667,66.7,63.2,450432,427201,23231,5.2
Hawaii,1982,316850,17919,-9197,-2.903,31.672,2776,12.747,2770,12.719,21781,1975,1995,12095,20695,29482,50177,15.836,6.531,41558,59374,17816,18.739,5.623,689917,66.4,62.3,458046,430039,28007,6.1
Hawaii,1983,310697,18626,-2112,-0.68,33.257,3175,14.337,2425,10.951,22520,1649,1688,11592,22059,29605,51664,16.628,7.1,34907,53776,18869,17.308,6.073,707417,66.6,62.6,470850,442989,27861,5.9
Hawaii,1984,313689,18963,7427,2.368,29.056,2914,12.838,2524,11.12,22893,1721,1779,9754,18684,34315,52999,16.895,5.956,29070,45572,16502,14.528,5.261,719500,65.9,62.3,473967,448206,25761,5.4
Hawaii,1985,320881,19057,7080,2.206,29.334,2811,12.248,2698,11.755,23008,1866,1900,9966,19060,35083,54143,16.873,5.94,28789,47063,18274,14.667,5.695,730667,65.9,62.5,481644,456507,25137,5.2
Hawaii,1986,334149,19374,17791,5.324,29.186,3074,13.199,2504,10.752,23574,1657,1678,10515,26374,40179,66553,19.917,7.893,30963,48762,17799,14.593,5.327,744917,66.2,63.1,493152,470179,22973,4.7
Hawaii,1987,355873,19865,21251,5.972,32.827,3395,14.207,2737,11.453,24226,1758,1809,12549,31260,48403,79663,22.385,8.784,35429,58412,22983,16.414,6.458,761917,67.1,64.7,511531,492626,18905,3.7
Hawaii,1988,375158,20482,17450,4.651,28.703,3514,14.246,2628,10.654,25109,1804,1855,10391,29011,42279,71290,19.003,7.733,34351,53840,19489,14.351,5.195,776167,66.8,64.7,518264,502303,15961,3.1
Hawaii,1989,396350,20937,25192,6.356,25.172,3318,13.024,2611,10.249,25829,1866,1896,12118,28922,46154,75076,18.942,7.297,30820,49884,19064,12.586,4.81,789750,67.1,65.5,530024,517005,13019,2.5
Hawaii,1990,419472,21585,23363,5.57,25.173,3425,13.046,2587,9.854,26673,1788,1836,11638,29645,46515,76160,18.156,7.067,32575,52797,20222,12.587,4.821,809147,68,66.3,550484,536157,14327,2.6
Hawaii,1991,432418,21886,4619,1.068,32.824,3597,13.292,2803,10.358,27458,1930,1981,14701,32550,43037,75587,17.48,7.527,47411,70968,23557,16.412,5.448,826510,68.3,66.4,564852,549066,15786,2.8
Hawaii,1992,439984,21772,12313,2.799,29.125,3014,10.983,2899,10.564,27501,1882,1913,12168,24184,52201,76385,17.361,5.497,43238,64072,20834,14.562,4.735,840084,68.7,65.8,576944,553015,23929,4.1
Hawaii,1993,439198,21781,-13000,-2.96,27.996,2876,10.483,3002,10.943,27371,1951,1995,11090,22698,38780,61478,13.998,5.168,50035,74478,24443,16.958,5.565,850658,68.4,65.4,582121,556734,25387,4.4
Hawaii,1994,430260,21778,-7212,-1.676,28.87,2816,10.278,2845,10.383,27385,1939,2021,15193,27585,34524,62109,14.435,6.411,45798,69321,23523,16.111,5.467,859398,67.9,64.3,583221,552936,30285,5.2
Hawaii,1995,422647,21894,-3344,-0.791,25.911,2892,10.523,2679,9.748,27588,1845,1889,8713,21970,32785,54755,12.955,5.198,39746,58099,18353,13.746,4.342,867555,67.5,63.8,585368,553124,32244,5.5
Hawaii,1996,415713,21713,-2084,-0.501,29.314,2795,10.204,2934,10.711,27322,1903,2009,10536,27843,33089,60932,14.657,6.698,42429,63016,20587,15.159,4.952,877213,67.8,63.8,594972,559622,35350,5.9
Hawaii,1997,417086,21639,-125,-0.03,28.576,2831,10.383,2973,10.904,27194,1910,1967,11030,19903,39690,59593,14.288,4.772,39622,59718,20096,14.318,4.818,888620,67.7,63.7,601737,565988,35749,5.9
Hawaii,1998,413053,21662,-5396,-1.306,27.323,2634,9.678,2817,10.351,27124,1747,1786,9922,21438,34992,56430,13.662,5.19,40754,61826,21072,14.968,5.102,895694,67.3,63.4,602650,567545,35105,5.8
Hawaii,1999,413352,21566,3277,0.793,26.849,2569,9.495,2713,10.027,26984,1690,1761,10780,23641,35126,58767,14.217,5.719,35039,55490,20451,13.424,4.948,899768,67.1,63.6,603670,572297,31373,5.2
Hawaii,2000,422968,21752,14097,3.333,21.71,2569,9.487,2387,8.815,27170,1496,1546,8546,18934,41076,60010,14.188,4.476,28777,45913,17136,10.855,4.051,900554,67.2,64.4,605395,579736,25659,4.2
Hawaii,2001,434539,22048,6093,1.402,23.897,2700,9.872,2383,8.713,27509,1437,1488,8339,19946,38067,58013,13.35,4.59,33875,51920,18045,11.948,4.153,907051,67,64.1,607556,581379,26177,4.3
Hawaii,2002,441054,22230,-3421,-0.776,30.435,3080,11.108,2842,10.25,27846,1645,1685,12152,28562,38555,67117,15.217,6.476,47034,70538,23504,15.993,5.329,914847,65.8,63.1,601786,577616,24170,4
Hawaii,2003,448429,22658,19412,4.329,22.895,2891,10.31,2488,8.873,28242,1506,1555,10282,21439,49307,70746,15.776,4.781,31474,51334,19860,11.448,4.429,922736,65.5,62.9,603936,580352,23584,3.9
Hawaii,2004,464568,23109,13105,2.821,21.783,2885,10.115,2335,8.186,28798,1524,1561,8836,20011,43693,63704,13.713,4.307,34974,50599,15625,10.892,3.363,941335,65,62.8,611752,591594,20158,3.3
Hawaii,2005,478900,23552,15351,3.205,23.666,3005,10.316,2367,8.126,29449,1519,1579,8332,27430,44590,72020,15.039,5.728,38296,56669,18373,11.833,3.837,951366,65.8,63.9,625530,607853,17677,2.8
Hawaii,2006,498166,24172,23686,4.755,20.949,3420,11.408,2363,7.882,30508,1575,1604,8762,27932,47934,75866,15.229,5.607,36666,52180,15514,10.474,3.114,960686,66.1,64.5,635415,619362,16053,2.5
Hawaii,2007,512829,24312,6534,1.274,27.219,3085,10.081,2889,9.44,30701,1767,1828,12437,25050,51277,76327,14.884,4.885,44763,69793,25030,13.609,4.881,968365,65.8,63.9,636710,619224,17486,2.7
Hawaii,2008,516898,23992,-202,-0.039,25.871,2666,8.723,2907,9.511,30444,1878,1931,11184,21494,45369,66863,12.935,4.158,47028,67065,20037,12.975,3.876,975321,65.8,63.1,641526,615767,25759,4
Hawaii,2009,502129,23566,-31943,-6.362,19.891,2563,8.457,3027,9.988,30073,1964,2017,13052,19726,30213,49939,9.945,3.928,59793,81882,22089,16.307,4.399,981691,64.4,60.1,631970,589798,42172,6.7
Hawaii,2010,482001,23132,-8810,-1.828,23.472,2403,8.05,2860,9.58,29624,1750,1797,9256,21379,35189,56568,11.736,4.435,46478,65378,18900,13.564,3.921,1030162,63,58.7,648549,604210,44339,6.8
Hawaii,2011,479926,22818,5138,1.071,21.393,2411,8.173,2653,8.993,29379,1664,1708,9276,19700,36774,56474,11.767,4.105,33958,51336,17378,10.697,3.621,1055845,62.6,58.3,660634,615470,45164,6.8
Hawaii,2012,486056,22702,7530,1.549,21.004,2322,7.932,2534,8.657,29166,1450,1480,7797,17136,41440,58576,12.051,3.526,34688,51046,16358,10.502,3.365,1065644,61,57.4,650415,611985,38430,5.9
Hawaii,2013,495972,22745,12337,2.487,19.443,2480,8.494,2396,8.207,29238,1406,1453,10407,19057,41497,60554,12.209,3.842,29091,48217,19126,9.722,3.856,1074149,60.6,57.7,650978,620005,30973,4.8
Hawaii,2014,510515,22726,16466,3.225,18.307,2502,8.526,2290,7.803,29453,1505,1522,8107,23541,39656,63197,12.379,4.611,31805,46731,14926,9.154,2.924,1080245,61.5,58.9,664014,635913,28101,4.2
Hawaii,2015,521092,22771,4010,0.77,19.687,2491,8.437,2348,7.953,29595,1488,1507,9342,17414,37890,55304,10.613,3.342,34562,51294,16732,9.844,3.211,1086642,61.7,59.6,670594,647616,22978,3.4
Hawaii,2016,526106,22993,5683,1.08,20.102,2620,8.791,2217,7.439,30004,1401,1446,8169,18664,39898,58562,11.131,3.548,39313,52879,13566,10.051,2.579,1093555,62.1,60.3,679121,659557,19564,2.9
Hawaii,2017,535640,23041,13821,2.58,21.803,2537,8.439,2414,8.029,30126,1519,1543,8287,28051,44164,72215,13.482,5.237,42196,58394,16198,10.902,3.024,1120898,62,60.7,695303,679865,15438,2.2
Hawaii,2018,547380,23188,7446,1.36,20.009,2531,8.379,2358,7.806,30293,1483,1522,10264,20047,42162,62209,11.365,3.662,37964,54763,16799,10.005,3.069,1124162,61.6,60.1,692457,675849,16608,2.4
Hawaii,2019,552210,23355,2551,0.462,19.021,2563,8.43,2343,7.706,30514,1569,1596,10411,19935,35133,55068,9.972,3.61,34314,52517,18203,9.51,3.296,1124354,61,59.5,686066,668769,17297,2.5
Hawaii,2020,551374,23065,-4229,-0.767,18.214,2388,7.861,2664,8.77,30240,1744,1776,8822,14611,35604,50215,9.107,2.65,37889,54444,16555,9.874,3.002,1125622,59.2,52.3,665964,588159,77805,11.7
Hawaii,2021,510029,22161,-78289,-15.35,14.799,2556,8.603,3623,12.194,29178,2045,2119,11464,14349,23390,37739,7.399,2.813,93709,116028,22319,22.749,4.376,1125168,59.6,56,670193,630151,40042,6
Hawaii,2022,488902,22949,36075,7.379,19.374,3330,11.276,2602,8.81,29897,1700,1729,7653,16755,66680,83435,17.066,3.427,32492,47360,14868,9.687,3.041,1123787,59.9,57.9,672727,650672,22055,3.3
Idaho,1978,229538,17454,19395,8.45,33.59,3668,18.751,2346,11.993,20223,1665,1682,7893,21700,36246,57946,25.245,9.454,24321,38551,14230,16.795,6.199,631667,65.7,62.1,414990,392150,22840,5.5
Idaho,1979,243825,17781,5747,2.357,34.814,3124,15.276,2741,13.403,20642,2051,2063,9671,18031,30159,48190,19.764,7.395,26754,42443,15689,17.407,6.435,647917,66.2,62.3,428898,403913,24985,5.8
Idaho,1980,246155,17845,-247,-0.1,35.474,2963,14.316,2870,13.867,20743,2106,2131,9840,17454,26207,43661,17.737,7.091,28451,43908,15457,17.838,6.279,659500,65.1,60.2,429395,396955,32440,7.6
Idaho,1981,245041,17637,-1873,-0.764,33.238,2767,13.38,2890,13.975,20618,2134,2168,10082,16968,23755,40723,16.619,6.925,27409,42596,15187,17.383,6.198,670250,64.3,59.4,430885,398041,32844,7.6
Idaho,1982,240327,17259,-8095,-3.368,33.527,2701,13.188,2983,14.565,20339,2111,2123,10115,16984,23303,40287,16.763,7.067,32336,48382,16046,20.132,6.677,679750,65.4,58.9,444686,400677,44009,9.9
Idaho,1983,235617,17575,-984,-0.418,35.299,2879,14.047,2572,12.549,20649,1792,1821,8681,17283,24302,41585,17.649,7.335,26125,42569,16444,18.067,6.979,689750,65.8,59.8,453929,412697,41232,9.1
Idaho,1984,242111,18442,13656,5.64,27.854,3250,15.391,2297,10.878,21593,1697,1709,8320,16722,30653,47375,19.567,6.907,21005,33719,12714,13.927,5.251,699083,66.2,61.4,462827,429535,33292,7.2
Idaho,1985,251415,18578,4798,1.908,32.303,3092,14.257,2922,13.473,21773,2119,2152,11272,16386,29019,45405,18.06,6.518,23999,40607,16608,16.151,6.606,700333,66.7,61.5,466831,430397,36434,7.8
Idaho,1986,255838,18667,3433,1.342,32.95,3018,13.812,2860,13.089,21930,2009,2034,10041,16802,28780,45582,17.817,6.567,27305,42149,14844,16.475,5.802,707083,66.8,61.2,472247,432737,39510,8.4
Idaho,1987,263845,18733,-10735,-4.069,36.829,3012,13.708,2949,13.421,22004,1967,2001,12112,20087,28498,48585,18.414,7.613,40242,59320,19078,22.483,7.231,711167,66.4,61.3,472236,436068,36168,7.7
Idaho,1988,262554,18991,13062,4.975,32.604,3030,13.632,2636,11.859,22424,1820,1863,11916,23726,32137,55863,21.277,9.037,25183,42801,17618,16.302,6.71,716250,66.9,62.8,479331,449810,29521,6.2
Idaho,1989,280642,19381,22789,8.12,27.415,2972,13.111,2524,11.135,22892,1715,1758,9768,23505,37753,61258,21.828,8.375,23566,38469,14903,13.707,5.31,725667,67.6,63.9,490404,463537,26867,5.5
Idaho,1990,299871,20446,15125,5.044,28.349,3391,14.443,2225,9.477,24061,1586,1612,9405,19472,38158,57630,19.218,6.493,28129,42505,14376,14.174,4.794,728642,67.8,64,494169,466472,27697,5.6
Idaho,1991,309532,20804,4732,1.529,33.334,3143,12.909,2509,10.305,24664,1714,1737,10209,21101,35221,56322,18.196,6.817,31525,51590,20065,16.667,6.482,751752,67.8,63.5,509647,477321,32326,6.3
Idaho,1992,317304,21471,13486,4.25,28.847,3296,13.17,2504,10.005,25423,1620,1660,8531,20459,38794,59253,18.674,6.448,30818,45767,14949,14.424,4.711,775171,68.3,63.9,529651,495136,34515,6.5
Idaho,1993,331573,22353,15112,4.558,26.294,3363,13.003,2475,9.569,26308,1624,1656,8917,20341,38363,58704,17.705,6.135,29650,43592,13942,13.147,4.205,802922,68.7,64.5,551298,517797,33501,6.1
Idaho,1994,351252,23665,21625,6.157,25.688,3933,14.519,2499,9.225,27806,1713,1749,9823,22092,44647,66739,19,6.29,30254,45114,14860,12.844,4.231,830424,70.8,66.9,587593,555266,32327,5.5
Idaho,1995,367983,24673,12497,3.396,27.795,3835,13.532,2741,9.672,28888,1910,1928,8785,21454,42184,63638,17.294,5.83,31266,51141,19875,13.898,5.401,856925,70.3,66.4,602000,568898,33102,5.5
Idaho,1996,377212,25345,12129,3.215,30.772,3982,13.625,3077,10.528,29679,2137,2162,11610,24670,45496,70166,18.601,6.54,37050,58037,20987,15.386,5.564,879010,70.2,66.4,617087,583655,33432,5.4
Idaho,1997,389809,26104,10995,2.821,32.257,4365,14.486,3486,11.569,30573,2308,2354,13732,27784,46081,73865,18.949,7.128,39161,62870,23709,16.128,6.082,899095,70.4,66.7,632640,599702,32938,5.2
Idaho,1998,413885,26682,20556,4.967,28.796,4046,13.041,3375,10.878,31361,2301,2321,11321,32085,48062,80147,19.365,7.752,40289,59591,19302,14.398,4.664,916680,71,67.3,651254,617126,34128,5.2
Idaho,1999,430582,27258,11893,2.762,27.483,4149,13.033,3238,10.171,32290,2212,2246,12944,27266,43796,71062,16.504,6.332,35461,59169,23708,13.742,5.506,933848,70,66.5,653982,621232,32750,5
Idaho,2000,448195,27585,12139,2.708,31.421,3960,12.178,3519,10.822,32737,2309,2380,13328,34180,48373,82553,18.419,7.626,49039,70414,21375,15.711,4.769,951079,69.5,66.3,661066,630228,30838,4.7
Idaho,2001,458639,27857,8188,1.785,31.559,4189,12.731,3938,11.968,33030,2325,2398,14340,30274,50285,80559,17.565,6.601,45304,72371,27067,15.78,5.902,969340,70,66.4,678281,643913,34368,5.1
Idaho,2002,458202,28173,-10980,-2.396,35.822,4469,13.392,3942,11.812,33635,2293,2343,18525,34456,47612,82068,17.911,7.52,62313,93048,30735,20.307,6.708,988250,69.4,65.5,685650,647019,38631,5.6
Idaho,2003,458684,29117,11467,2.5,28.782,4627,13.552,3576,10.474,34668,2280,2321,10371,26850,50627,77477,16.891,5.854,44100,66010,21910,14.391,4.777,1006838,68.7,64.9,691702,653299,38403,5.6
Idaho,2004,474758,30235,20413,4.3,27.083,4687,13.291,3489,9.894,35864,2194,2221,11847,39256,45447,84703,17.841,8.269,41486,64290,22804,13.542,4.803,1028370,68.3,65,702872,668638,34234,4.9
Idaho,2005,499601,31793,28545,5.714,25.323,5308,14.439,3520,9.575,37655,2303,2337,13188,36173,55629,91802,18.375,7.24,43025,63257,20232,12.662,4.05,1056225,69.1,66.4,730354,701400,28954,4
Idaho,2006,528353,33891,26878,5.087,25.824,6301,16.206,3834,9.861,40115,2660,2689,17304,35055,60045,95100,17.999,6.635,43076,68222,25146,12.912,4.759,1086238,68.5,66.2,744475,718848,25627,3.4
Idaho,2007,544086,35167,4260,0.783,32.999,5887,14.394,4269,10.438,41709,2933,2958,16824,35422,58610,94032,17.283,6.51,63488,89772,26284,16.5,4.831,1112418,67.9,65.8,755287,732155,23132,3.1
Idaho,2008,541083,34546,-10708,-1.979,27.407,4791,11.546,5179,12.481,41300,3629,3676,16932,27385,46762,74147,13.703,5.061,59110,84855,25745,15.682,4.758,1134171,67,63.6,759676,721828,37848,5
Idaho,2009,518321,32663,-36897,-7.119,22.284,3756,9.288,5759,14.241,39437,3752,3796,17563,23803,33949,57752,11.142,4.592,66279,94649,28370,18.261,5.473,1149973,66.4,60.6,763633,696832,66801,8.7
Idaho,2010,494418,31953,-10550,-2.134,25.092,3993,10.217,4719,12.075,38719,3058,3123,12735,20859,41170,62029,12.546,4.219,52272,72579,20307,14.68,4.107,1165430,65.4,59.7,762147,695265,66882,8.8
Idaho,2011,485533,31143,-6110,-1.258,24.869,3838,10.014,4594,11.986,37949,2870,2960,13991,20032,40342,60374,12.435,4.126,44981,66484,21503,13.693,4.429,1179092,64.8,59.5,764205,701660,62545,8.2
Idaho,2012,488435,31243,12640,2.588,23.868,3969,10.449,3883,10.223,38026,2374,2412,10478,23098,47831,70929,14.522,4.729,36073,58289,22216,11.934,4.548,1193211,64.7,59.9,772112,714969,57143,7.4
Idaho,2013,504037,31479,17162,3.405,22.277,4027,10.552,3729,9.771,38313,2398,2415,11569,22659,50646,73305,14.544,4.496,34473,56143,21670,11.139,4.299,1208621,64.3,59.9,777606,724545,53061,6.8
Idaho,2014,521418,32193,17876,3.428,22.766,4229,10.912,3345,8.631,39198,2156,2200,9267,22900,54329,77229,14.811,4.392,36231,59353,23122,11.383,4.434,1226459,63.3,60.6,776937,742805,34132,4.4
Idaho,2015,540088,32781,17948,3.323,20.547,4272,10.782,3448,8.703,40032,2205,2237,10248,23339,50095,73434,13.597,4.321,35413,55486,20073,10.274,3.717,1246558,63.8,61.3,795014,764121,30893,3.9
Idaho,2016,556758,33501,16283,2.925,21.432,4474,11.045,3482,8.596,41004,2229,2274,9942,24006,51939,75945,13.641,4.312,40845,59662,18817,10.716,3.38,1274370,63.8,61.5,812921,783180,29741,3.7
Idaho,2017,571330,34102,14871,2.603,22.804,4435,10.727,3743,9.053,41690,2284,2319,10879,25957,54056,80013,14.005,4.543,43832,65142,21310,11.402,3.73,1314456,63.9,61.8,839776,812875,26901,3.2
Idaho,2018,588533,35362,20292,3.448,22.193,4934,11.639,3493,8.239,43114,2237,2295,11187,28923,56676,85599,14.544,4.914,45399,65307,19908,11.097,3.383,1346386,64.1,62.2,862434,837767,24667,2.9
Idaho,2019,608018,36704,20628,3.393,18.927,5164,11.772,3676,8.38,44610,2423,2456,10135,29164,49003,78167,12.856,4.797,40400,57539,17139,9.463,2.819,1381645,64.3,62.5,888611,862940,25671,2.9
Idaho,2020,629216,37605,21026,3.342,19.667,5288,11.703,4144,9.171,45758,2672,2705,11614,30953,51948,82901,13.175,4.919,42392,61875,19483,9.834,3.096,1420560,63.3,59.8,899807,850130,49677,5.5
Idaho,2021,644606,39380,9046,1.403,23.795,6019,12.883,4100,8.775,47681,2659,2727,14079,29508,56229,85737,13.301,4.578,53191,76691,23500,11.897,3.646,1466287,62.9,60.6,921718,888950,32768,3.6
Idaho,2022,667592,40763,39323,5.89,21.983,6483,13.367,4807,9.911,49339,3495,3542,16277,35233,77469,112702,16.882,5.278,47915,73379,25464,10.992,3.814,1501224,62.9,61.2,944919,918106,26813,2.8
Illinois,1978,3962312,179075,199341,5.031,25.487,26955,13.012,21802,10.525,209727,14963,15213,86337,213566,490719,704285,17.775,5.39,318938,504944,186006,12.744,4.694,8365417,64.8,60.9,5423786,5098246,325540,6
Illinois,1979,4160588,182432,166914,4.012,25.906,25185,11.879,21634,10.204,213789,14815,15064,81756,211525,494316,705841,16.965,5.084,363253,538927,175674,12.953,4.222,8420333,64.9,61.3,5462279,5159018,303261,5.6
Illinois,1980,4201004,182767,-80000,-1.904,26.014,23967,11.186,23241,10.847,214622,16479,16685,88112,190149,356281,546430,13.007,4.526,452392,626430,174038,14.911,4.143,8473750,65.4,60,5539806,5086190,453616,8.2
Illinois,1981,4129997,182392,-71117,-1.722,26.713,23784,11.072,23161,10.782,215123,16673,16930,96515,205197,346423,551620,13.356,4.968,455438,622737,167299,15.078,4.051,8528750,65.6,60,5595838,5113454,482384,8.6
Illinois,1982,3991654,180142,-162888,-4.081,25.348,23146,10.802,24776,11.563,213457,17470,17764,101965,187803,318103,505906,12.674,4.705,470835,668794,197959,16.755,4.959,8557500,65.6,58.1,5614852,4974453,640399,11.4
Illinois,1983,3882719,183151,-72215,-1.86,29.513,25625,11.908,22433,10.425,216789,15550,15847,89706,201007,371947,572954,14.757,5.177,463275,645169,181894,16.616,4.685,8578750,65.3,57.6,5600205,4945354,654851,11.7
Illinois,1984,3923015,186371,157192,4.007,25.708,27111,12.394,23290,10.647,220654,16825,17060,119976,214588,446871,661459,16.861,5.47,300913,504267,203354,12.854,5.184,8613583,65.1,59.2,5610383,5098532,511851,9.1
Illinois,1985,4045719,187342,80689,1.994,29.565,26352,11.909,25064,11.327,221914,17929,18322,125161,241772,436980,678752,16.777,5.976,355701,598063,242362,14.783,5.991,8635917,65.5,59.6,5659777,5146361,513416,9.1
Illinois,1986,4137989,190048,98422,2.378,27.26,27223,12.158,23004,10.273,226026,16304,16572,107100,219131,443303,662434,16.009,5.296,381494,564012,182518,13.63,4.411,8681500,65.6,60.1,5693266,5220347,472919,8.3
Illinois,1987,4204384,191966,6351,0.151,32.734,28886,12.681,25277,11.097,229594,17339,17638,109118,257282,437194,694476,16.518,6.119,451428,688125,236697,16.367,5.63,8740917,65.9,61,5764392,5334172,430220,7.5
Illinois,1988,4287483,195555,151113,3.525,27.861,28737,12.363,23583,10.146,235014,16192,16466,105597,265549,482839,748388,17.455,6.194,389432,597275,207843,13.931,4.848,8790250,66.4,61.9,5839006,5445160,393846,6.7
Illinois,1989,4437351,198826,137576,3.1,27.081,28916,12.176,24122,10.158,239874,16406,16858,107019,272185,466234,738419,16.641,6.134,394462,600843,206381,13.541,4.651,8832417,67.9,63.8,5994480,5631348,363132,6.1
Illinois,1990,4582926,202725,110978,2.422,25.433,27943,11.526,22985,9.481,244906,16308,16630,103959,234957,458812,693769,15.138,5.127,392409,582791,190382,12.717,4.154,8691495,68.2,63.9,5928974,5557044,371930,6.3
Illinois,1991,4610540,202556,-55027,-1.194,28.405,27955,11.362,25311,10.288,247353,17676,18080,140679,256441,398371,654812,14.203,5.562,475612,709839,234227,15.396,5.08,8768688,67.6,62.7,5929544,5497100,432444,7.3
Illinois,1992,4557674,202935,-17291,-0.379,29.997,26722,10.788,25195,10.171,248468,16278,16650,124301,228368,455207,683575,14.998,5.011,462036,700866,238830,15.378,5.24,8844259,68.2,62.8,6028864,5555116,473748,7.9
Illinois,1993,4586507,206820,66082,1.441,27.19,26398,10.55,22921,9.161,251953,15222,15610,91734,214671,474948,689619,15.036,4.68,435573,623537,187964,13.595,4.098,8928912,68.1,63,6078012,5623227,454785,7.5
Illinois,1994,4692791,210306,114160,2.433,25.329,27508,10.812,23183,9.112,256593,15932,16280,103517,233489,474993,708482,15.097,4.975,389168,594322,205154,12.665,4.372,8989316,68,64,6112726,5756661,356065,5.8
Illinois,1995,4816465,214414,151881,3.153,24.643,28757,11.092,23292,8.984,261991,15780,16169,102696,258686,486645,745331,15.475,5.371,397115,593450,196335,12.321,4.076,9040636,68.3,64.7,6173214,5851700,321514,5.2
Illinois,1996,4866477,215752,49674,1.021,27.065,28333,10.787,24745,9.421,264462,17030,17471,101564,244941,463284,708225,14.553,5.033,465379,658551,193172,13.532,3.969,9101290,68.6,65,6244016,5913079,330937,5.3
Illinois,1997,4952542,216973,81382,1.643,28.773,28919,10.902,27391,10.326,266032,17791,18313,122445,264546,529322,793868,16.03,5.342,460334,712486,252152,14.386,5.091,9161360,68.7,65.4,6296315,5994538,301777,4.8
Illinois,1998,5120684,219988,125786,2.456,25.755,27697,10.309,24410,9.086,270310,15920,16311,99181,247141,538051,785192,15.334,4.826,451662,659406,207744,12.877,4.057,9230764,68.7,65.6,6339411,6055561,283850,4.5
Illinois,1999,5251495,220563,114787,2.186,25.771,27076,9.98,25199,9.288,272250,16229,16704,105451,266820,524660,791480,15.072,5.081,451507,676693,225186,12.886,4.288,9298418,69.5,66.4,6463079,6178482,284597,4.4
Illinois,2000,5377725,220896,119265,2.218,27.17,27179,9.951,25642,9.389,273889,16292,16750,110878,262937,586901,849838,15.803,4.889,460113,730573,270460,13.585,5.029,9346902,69.5,66.4,6494429,6206060,288369,4.4
Illinois,2001,5401704,219980,-83854,-1.552,27.701,26292,9.614,27003,9.874,273127,16700,17366,116203,260419,487747,748166,13.851,4.821,547660,832020,284360,15.403,5.264,9408241,68.6,64.9,6454092,6103092,351000,5.4
Illinois,2002,5280782,218507,-221318,-4.191,29.65,29620,10.829,30314,11.082,273186,17442,18089,165739,313465,469410,782875,14.825,5.936,669117,1004193,335076,19.016,6.345,9465460,67,62.6,6341891,5925990,415901,6.6
Illinois,2003,5180534,219876,18040,0.348,28.703,28667,10.461,26815,9.785,274958,16445,16799,113771,242875,518662,761537,14.7,4.688,492226,743497,251271,14.352,4.85,9515975,66.3,61.8,6310520,5885134,425386,6.7
Illinois,2004,5197683,222702,15093,0.29,27.458,29049,10.507,26025,9.413,277987,16210,16930,117603,226764,501913,728677,14.019,4.363,474286,713584,239298,13.729,4.604,9559591,66.4,62.3,6348716,5955739,392977,6.2
Illinois,2005,5212682,224985,18801,0.361,26.702,30419,10.879,27224,9.736,281219,17136,17552,107642,260188,454562,714750,13.712,4.991,473738,695949,222211,13.351,4.263,9611488,66.7,62.9,6410767,6044685,366082,5.7
Illinois,2006,5288678,228002,115812,2.19,25.447,32794,11.554,27490,9.685,286494,18028,18374,121715,281091,507624,788715,14.913,5.315,438043,672903,234860,12.723,4.441,9675598,67.3,64.3,6515687,6217917,297770,4.6
Illinois,2007,5350520,228626,3761,0.07,29.01,31195,10.855,29256,10.18,288343,18264,18549,117352,274009,505850,779859,14.575,5.121,528206,776098,247892,14.505,4.633,9743313,68.1,64.7,6639198,6301409,337789,5.1
Illinois,2008,5370851,226326,38310,0.713,26.242,28546,9.926,29820,10.369,286945,19290,19581,109951,223586,519421,743007,13.834,4.163,477758,704697,226939,13.121,4.225,9811776,67.8,63.4,6652942,6222179,430763,6.5
Illinois,2009,5235657,220992,-336200,-6.421,20.405,25022,8.797,31869,11.204,281018,19988,20360,125164,193548,340610,534158,10.202,3.697,632040,870358,238318,16.624,4.552,9877039,66.8,60,6601620,5928539,673081,10.2
Illinois,2010,5014574,218080,-145750,-2.907,21.628,25584,9.151,28669,10.255,278020,17273,17595,101553,194491,347775,542266,10.814,3.879,490016,688016,198000,13.72,3.948,9905097,66.8,59.7,6612433,5918202,694231,10.5
Illinois,2011,4983453,217648,78021,1.566,21.77,27073,9.736,26993,9.707,278122,16803,17314,88188,187362,433120,620482,12.451,3.76,368179,542461,174282,10.885,3.497,9949849,66,59.6,6567531,5925787,641744,9.8
Illinois,2012,5058379,218627,76084,1.504,23.195,26712,9.598,26301,9.451,278500,15535,16073,86521,196088,466646,662734,13.102,3.876,385498,586650,201152,11.598,3.977,9992930,65.9,59.9,6583689,5989454,594235,9
Illinois,2013,5124977,218421,61116,1.193,22.431,26272,9.433,26091,9.368,278610,15938,16232,99794,196165,439738,635903,12.408,3.828,380711,574787,194076,11.215,3.787,10027607,65.4,59.4,6556593,5961201,595392,9.1
Illinois,2014,5224022,218361,128516,2.46,20.851,26132,9.362,25193,9.025,279606,15665,15930,85100,231972,441163,673135,12.885,4.44,357398,544619,187221,10.425,3.584,10049204,64.8,60.2,6516372,6049059,467313,7.2
Illinois,2015,5306666,219779,105752,1.993,22.759,26746,9.531,24745,8.818,281629,15128,15530,84899,203239,506385,709624,13.372,3.83,385063,603872,218809,11.379,4.123,10052540,64.8,60.9,6511797,6119934,391863,6
Illinois,2016,5391711,221359,47252,0.876,22.647,27011,9.54,24015,8.482,284642,15580,15924,85991,214740,443050,657790,12.2,3.983,445695,610538,164843,11.324,3.057,10048210,65.3,61.4,6559038,6172672,386366,5.9
Illinois,2017,5403751,221146,-6166,-0.114,24.516,25741,9.043,25775,9.055,284619,15583,16055,114600,203179,459223,662402,12.258,3.76,428343,668568,240225,12.372,4.446,10141740,64.7,61.5,6562291,6237933,324358,4.9
Illinois,2018,5426232,220836,36250,0.668,22.582,24178,8.508,24916,8.768,283814,15472,15815,84316,196655,452283,648938,11.959,3.624,432896,612688,179792,11.291,3.313,10134812,64.7,61.9,6557416,6270844,286572,4.4
Illinois,2019,5462603,220727,37107,0.679,20.736,24942,8.776,24213,8.52,284569,16108,16380,93220,183794,419684,603478,11.047,3.365,393674,566371,172697,10.368,3.161,10125894,64.6,62.1,6543691,6283464,260227,4
Illinois,2020,5493700,218703,-2458,-0.045,22.288,24688,8.706,26681,9.409,282577,16440,16784,95196,191172,421035,612207,11.144,3.48,415078,614665,199587,11.189,3.633,10101689,62.6,56.8,6321066,5735263,585803,9.3
Illinois,2021,5362248,219217,-260080,-4.85,20.927,28298,10.018,28475,10.08,282396,16752,17160,88738,179341,381744,561085,10.464,3.345,631974,821165,189191,15.314,3.528,10053445,62.9,59.1,6327675,5942191,385484,6.1
Illinois,2022,5359933,222489,256937,4.794,22.57,30156,10.625,27200,9.583,285305,18245,18748,97837,228521,633286,861807,16.079,4.264,367441,604870,237429,11.285,4.43,10011825,64.1,61.2,6421708,6127480,294228,4.6
Indiana,1978,1737998,81381,105340,6.061,22.624,12770,13.237,9825,10.184,97944,6668,6755,34077,88869,213076,301945,17.373,5.113,130292,196605,66313,11.312,3.815,3928917,65.8,62.1,2584346,2440637,143709,5.6
Indiana,1979,1851083,83686,93008,5.025,21.389,11902,11.959,9323,9.368,100814,6694,6779,35542,83535,207433,290968,15.719,4.513,133119,197960,64841,10.694,3.503,3977750,66.2,61.9,2632661,2463223,169438,6.4
Indiana,1980,1854961,83629,-81438,-4.39,23.245,10920,10.815,10684,10.581,101090,7620,7712,35277,77127,138462,215589,11.622,4.158,227397,297027,69630,16.013,3.754,4013083,65.4,59.1,2624984,2370833,254151,9.7
Indiana,1981,1797079,82861,-33977,-1.891,24.402,10367,10.276,10683,10.59,100724,7702,7828,37909,75971,143294,219265,12.201,4.227,184570,253242,68672,14.092,3.821,4035000,65,58.6,2621027,2365811,255216,9.7
Indiana,1982,1738878,81544,-82881,-4.766,23.41,10332,10.307,11338,11.31,99742,7971,8093,39315,68867,134671,203538,11.705,3.96,214343,286419,72076,16.471,4.145,4047750,64.5,56.8,2611354,2298111,313243,12
Indiana,1983,1680129,83192,-34847,-2.074,27.353,12354,12.286,10801,10.742,101329,7663,7796,38072,87291,142495,229786,13.677,5.195,196258,264633,68375,15.751,4.07,4055750,63.9,56.8,2590061,2302886,287175,11.1
Indiana,1984,1718048,85809,108642,6.324,24.68,14159,13.771,11363,11.052,104213,8553,8680,50349,111726,208922,320648,18.664,6.503,117404,212006,94602,12.34,5.506,4076667,64.5,59.1,2631164,2408644,222520,8.5
Indiana,1985,1789941,86501,37275,2.082,27.826,12619,12.062,11763,11.244,105045,8419,8607,55135,100616,185694,286310,15.995,5.621,156639,249035,92396,13.913,5.162,4092250,66,60.9,2701795,2494020,207775,7.7
Indiana,1986,1834817,88122,50699,2.763,26.491,13301,12.52,10853,10.216,107459,7733,7904,48608,109117,184616,293733,16.009,5.947,162329,243034,80705,13.246,4.399,4120000,66.5,62,2740825,2554884,185941,6.8
Indiana,1987,1900929,89632,70199,3.693,28.527,13894,12.797,11569,10.655,109736,7925,8161,54997,127274,214068,341342,17.957,6.695,167976,271143,103167,14.264,5.427,4158417,66.1,62,2747749,2579001,168748,6.1
Indiana,1988,1966348,91499,70621,3.591,26.664,13759,12.372,11042,9.929,112565,7629,7783,54122,119880,212891,332771,16.923,6.097,171219,262150,90931,13.332,4.624,4190833,66.6,63.2,2791749,2647406,144343,5.2
Indiana,1989,2055904,93370,98428,4.788,23.769,13560,11.898,10870,9.538,115316,7717,7921,51620,119198,223567,342765,16.672,5.798,154773,244337,89564,11.885,4.356,4216333,67.6,64.4,2850748,2716337,134411,4.7
Indiana,1990,2130485,95122,45054,2.115,24.855,13334,11.433,10766,9.231,117910,7810,7998,48399,106395,203425,309820,14.542,4.994,183951,264766,80815,12.428,3.793,4182011,67.2,63.8,2810678,2668343,142335,5.1
Indiana,1991,2124843,95136,-39799,-1.873,27.055,13311,11.224,11681,9.85,119408,8283,8481,63715,113360,174083,287443,13.528,5.335,225317,327242,101925,15.401,4.797,4242413,66,62.3,2800684,2641117,159567,5.7
Indiana,1992,2138492,95728,30841,1.442,29.254,12781,10.657,11435,9.534,120609,7635,7799,50141,120648,222987,343635,16.069,5.642,217704,312794,95090,14.627,4.447,4289722,66.7,62.6,2860440,2686092,174348,6.1
Indiana,1993,2186473,97970,58778,2.688,24.169,12601,10.358,10473,8.609,122713,7097,7288,43079,93696,229309,323005,14.773,4.285,184740,264227,79487,12.085,3.635,4342364,67.9,64.5,2949646,2799184,150462,5.1
Indiana,1994,2254369,100092,50056,2.22,24.706,13255,10.671,10546,8.49,125570,7368,7642,48553,103144,225389,328533,14.573,4.575,185305,278477,93172,12.353,4.133,4385756,69.6,66.4,3053341,2910429,142912,4.7
Indiana,1995,2324049,102318,92333,3.973,22.689,14213,11.177,10984,8.637,128781,7739,7990,47433,121240,234742,355982,15.317,5.217,176994,263649,86655,11.344,3.729,4431231,70.5,67.3,3122864,2984247,138617,4.4
Indiana,1996,2366556,103066,20792,0.879,27.227,13697,10.591,11770,9.101,130291,8196,8437,54215,129539,213419,342958,14.492,5.474,221910,322166,100256,13.613,4.236,4478040,69.2,66.5,3099954,2976644,123310,4
Indiana,1997,2410824,103498,40790,1.692,28.117,14111,10.787,13057,9.981,131344,8713,8988,60043,120849,258864,379713,15.75,5.013,219892,338923,119031,14.058,4.937,4510432,69.1,66.8,3118016,3011559,106457,3.4
Indiana,1998,2497809,104542,64044,2.564,24.554,13258,10.014,11977,9.046,133038,7943,8141,49690,127498,243196,370694,14.841,5.104,210722,306650,95928,12.277,3.84,4539240,68.8,66.7,3121554,3027701,93853,3
Indiana,1999,2555069,104312,45961,1.799,25.057,12560,9.423,12146,9.113,133496,8220,8442,55892,118404,247663,366067,14.327,4.634,214486,320106,105620,12.528,4.134,4569132,68.3,66.3,3121742,3029823,91919,2.9
Indiana,2000,2630223,103884,97440,3.705,22.944,12581,9.414,12427,9.299,133712,8128,8398,48846,118865,280313,399178,15.177,4.519,203862,301738,97876,11.472,3.721,4600535,67.9,65.9,3125304,3030889,94415,3
Indiana,2001,2620638,103115,-69734,-2.661,25.518,12493,9.379,13340,10.015,132778,7984,8294,62032,114810,219560,334370,12.759,4.381,265201,404104,138903,15.42,5.3,4630123,67.9,65,3143985,3010490,133495,4.2
Indiana,2002,2566985,103355,-75141,-2.927,29.299,14345,10.742,13697,10.257,133868,7964,8309,63168,152417,223635,376052,14.65,5.938,315861,451193,135332,17.577,5.272,4657190,67.9,64.4,3161709,2997963,163746,5.2
Indiana,2003,2533806,103681,11027,0.435,28.353,12952,9.658,12406,9.251,134375,7736,7978,51914,116089,254149,370238,14.612,4.582,231324,359211,127887,14.177,5.047,4687701,67.8,64.2,3178568,3011507,167061,5.3
Indiana,2004,2560662,104770,43471,1.698,24.245,13358,9.877,11630,8.599,136106,7630,7886,51388,113643,240248,353891,13.82,4.438,210924,310420,99496,12.123,3.886,4715526,67.1,63.5,3165247,2993991,171256,5.4
Indiana,2005,2592529,104907,18994,0.733,24.744,13081,9.592,12549,9.202,136642,8122,8368,53313,117001,222737,339738,13.105,4.513,219689,320744,101055,12.372,3.898,4752908,67.4,63.7,3202215,3029258,172957,5.4
Indiana,2006,2634041,105894,54368,2.064,23.686,14901,10.809,12480,9.053,139071,8199,8369,49240,128185,238138,366323,13.907,4.866,217854,311955,94101,11.843,3.572,4796258,67.5,64.1,3235980,3075761,160219,5
Indiana,2007,2648262,105770,-25738,-0.972,27.666,14222,10.201,13376,9.594,139843,8567,8751,56578,124404,241932,366336,13.833,4.698,275618,392074,116456,14.805,4.397,4836385,66.2,63.2,3202589,3054548,148041,4.6
Indiana,2008,2615549,104254,-40311,-1.541,24.973,12294,8.844,13880,9.985,138211,8914,9140,60127,100065,226527,326592,12.487,3.826,244167,366903,122736,14.028,4.693,4874492,66.6,62.6,3244790,3053593,191197,5.9
Indiana,2009,2516709,101307,-164978,-6.555,20.722,10482,7.663,14052,10.272,135010,8991,9254,58075,86368,174394,260762,10.361,3.432,312700,425740,113040,16.917,4.492,4907391,65.5,58.7,3216535,2880173,336362,10.5
Indiana,2010,2415398,99582,-38835,-1.608,22.676,10311,7.685,12065,8.993,133286,7607,7797,45071,87697,186155,273852,11.338,3.631,224933,312687,87754,12.946,3.633,4962815,64,57.5,3175885,2854843,321042,10.1
Indiana,2011,2414095,98502,38202,1.582,21.086,11023,8.291,11681,8.786,132623,7357,7682,40420,80665,212056,292721,12.125,3.341,178602,254519,75917,10.543,3.145,5002729,63.7,58.1,3189011,2904397,284614,8.9
Indiana,2012,2468804,98595,72170,2.923,21.51,11326,8.534,11120,8.379,132816,6644,6870,40923,97874,239816,337690,13.678,3.964,182946,265520,82574,10.755,3.345,5032521,63,57.9,3172556,2911925,260631,8.2
Indiana,2013,2524748,98004,38438,1.522,20.896,10334,7.799,10890,8.218,132234,6769,6870,41358,81708,220513,302221,11.97,3.236,184746,263783,79037,10.448,3.13,5064442,63.1,58.3,3193683,2953672,240011,7.5
Indiana,2014,2573871,97400,59627,2.317,19.423,10607,8.022,10645,8.051,132197,6643,6761,40063,86982,222604,309586,12.028,3.379,171598,249959,78361,9.711,3.044,5093837,63.4,59.6,3228524,3036685,191839,5.9
Indiana,2015,2636273,97708,68575,2.601,19.722,11520,8.664,9997,7.519,133720,6228,6418,38227,98859,229684,328543,12.462,3.75,189253,259968,70715,9.861,2.682,5117280,63.8,60.8,3266392,3109791,156601,4.8
Indiana,2016,2699546,98236,58115,2.153,19.54,11507,8.537,9439,7.003,135821,6190,6370,37825,100321,221543,321864,11.923,3.716,195989,263749,67760,9.77,2.51,5148022,64.7,61.9,3331821,3186420,145401,4.4
Indiana,2017,2752496,98663,52590,1.911,21.822,10885,7.996,10280,7.552,136431,6090,6250,44254,94450,258470,352920,12.822,3.431,209195,300330,91135,10.911,3.311,5189801,64.2,62,3333693,3217049,116644,3.5
Indiana,2018,2797093,99065,30434,1.088,22.126,10819,7.923,10521,7.705,136694,6355,6615,50099,94467,245403,339870,12.151,3.377,207644,309436,101792,11.063,3.639,5224191,64.9,62.7,3392579,3276805,115774,3.4
Indiana,2019,2824133,99166,24061,0.852,18.508,10776,7.85,9662,7.039,137830,6496,6659,39093,81544,203866,285410,10.106,2.887,192018,261349,69331,9.254,2.455,5259231,64.6,62.5,3399870,3287462,112408,3.3
Indiana,2020,2829907,98657,-11133,-0.393,21.029,10904,7.926,11473,8.34,137283,6762,6970,45056,89537,208010,297547,10.514,3.164,210172,308680,98508,10.908,3.481,5283865,63,58.4,3328778,3086279,242499,7.3
Indiana,2021,2791258,99879,-67580,-2.421,21.85,12534,9.092,11334,8.221,138464,6711,6965,40277,95529,209412,304941,10.925,3.422,280613,372521,91908,13.346,3.293,5310798,62.8,60.3,3332745,3201829,130916,3.9
Indiana,2022,2814004,101328,115360,4.099,21.973,13445,9.656,11840,8.503,140046,7508,7830,48638,109546,314976,424522,15.086,3.893,211666,309162,97496,10.987,3.465,5337181,63.2,61.3,3373887,3270662,103225,3.1
Iowa,1978,847517,55843,57913,6.833,24.314,8521,13.232,6549,10.17,65384,4687,4737,22776,53298,107647,160945,18.99,6.289,65848,103032,37184,12.157,4.387,2129333,66.5,63.9,1415772,1360894,54878,3.9
Iowa,1979,897651,56764,37758,4.206,24.581,7695,11.651,6728,10.187,66529,4931,4984,24185,47670,100414,148084,16.497,5.311,71396,110326,38930,12.291,4.337,2142083,66.4,63.6,1422486,1363067,59419,4.2
Iowa,1980,907687,56672,-11705,-1.29,26.28,7137,10.708,6991,10.489,66722,5281,5314,23959,40923,78349,119272,13.14,4.508,92770,130977,38207,14.43,4.209,2151250,66.4,62.5,1428311,1344122,84189,5.9
Iowa,1981,892145,56370,-19176,-2.149,27.498,6906,10.355,6859,10.285,66716,5248,5333,23060,60849,61810,122659,13.749,6.821,93345,141835,48490,15.898,5.435,2160083,66.2,61.8,1428916,1335522,93394,6.5
Iowa,1982,862290,54651,-41106,-4.767,24.113,6271,9.509,7847,11.898,65162,5770,5825,26577,38353,65611,103964,12.057,4.448,102302,145070,42768,16.824,4.96,2158583,65.6,60.1,1415639,1296872,118767,8.4
Iowa,1983,831474,54828,-24039,-2.891,29.425,6794,10.41,6668,10.217,65325,4827,4875,22454,45819,76513,122332,14.713,5.511,98720,146371,47651,17.604,5.731,2159250,65.6,60.2,1417144,1300692,116452,8.2
Iowa,1984,835625,55929,31733,3.798,24.511,7727,11.712,6509,9.866,66586,4807,4887,21849,45662,88480,134142,16.053,5.464,67348,102409,35061,12.255,4.196,2160250,65.8,61.2,1421296,1321571,99725,7
Iowa,1985,851980,54544,1329,0.156,27.871,6561,9.963,8024,12.185,65121,5892,5987,28724,40097,79959,120056,14.091,4.706,71044,118727,47683,13.935,5.597,2149083,66.2,61.3,1423606,1318126,105480,7.4
Iowa,1986,859740,53634,8900,1.035,29.239,6473,9.996,7265,11.219,64359,5182,5279,27386,52948,81641,134589,15.655,6.159,78727,125689,46962,14.619,5.462,2139500,67.5,62.9,1443125,1345316,97809,6.8
Iowa,1987,872929,53370,19093,2.187,29.035,7062,10.976,7090,11.02,64324,4787,4853,26058,57233,88587,145820,16.705,6.556,77089,126727,49638,14.517,5.686,2138333,68.4,64.5,1461652,1379449,82203,5.6
Iowa,1988,907108,53806,44983,4.959,24.14,6784,10.477,6077,9.385,65105,4236,4316,25109,49876,104595,154471,17.029,5.498,67316,109488,42172,12.07,4.649,2148583,69.3,66.1,1489045,1419797,69248,4.7
Iowa,1989,960112,54302,55827,5.815,22.232,6670,10.182,5903,9.011,65893,4205,4295,25604,60900,101653,162553,16.931,6.343,65922,106726,40804,11.116,4.25,2154000,69.8,66.7,1502484,1437734,64750,4.3
Iowa,1990,1004993,55064,31935,3.178,22.567,6653,10.009,5557,8.36,67017,4072,4173,23050,47133,98198,145331,14.461,4.69,79624,113396,33772,11.283,3.36,2088455,69.6,66.5,1453820,1389360,64460,4.4
Iowa,1991,1024277,55149,6099,0.595,25.559,6742,9.998,5732,8.5,67937,4053,4133,23943,45974,91024,136998,13.375,4.488,89701,130899,41198,12.78,4.022,2104403,69.9,66.6,1470842,1401981,68861,4.7
Iowa,1992,1033749,55481,17087,1.653,26.427,6551,9.606,5950,8.725,68496,3922,4009,24737,51353,102326,153679,14.866,4.968,91580,136592,45012,13.213,4.354,2124507,71.8,68.6,1525309,1456943,68366,4.5
Iowa,1993,1036604,56192,16126,1.556,23.138,6204,9.02,5585,8.12,69087,3785,3854,18128,39272,96781,136053,13.125,3.789,85108,119927,34819,11.569,3.359,2142778,72.6,69.6,1555790,1491661,64129,4.1
Iowa,1994,1062389,56928,24313,2.289,22.713,6667,9.566,5682,8.153,70186,4017,4126,22007,45707,99258,144965,13.645,4.302,79427,120652,41225,11.357,3.88,2159048,73,70.3,1575089,1518146,56943,3.6
Iowa,1995,1095733,57682,41964,3.83,20.801,6894,9.747,5798,8.197,71278,4092,4203,24045,48073,107852,155925,14.23,4.387,74187,113961,39774,10.4,3.63,2177652,73,70.4,1588738,1532912,55826,3.5
Iowa,1996,1124613,57875,29706,2.641,22.031,6671,9.346,5908,8.277,71759,4188,4269,22551,52742,100843,153585,13.657,4.69,87714,123879,36165,11.015,3.216,2192256,73.4,70.8,1609787,1551881,57906,3.6
Iowa,1997,1149892,57945,14084,1.225,27.947,6936,9.648,6640,9.236,72038,4381,4490,27992,64528,110234,174762,15.198,5.612,102304,160678,58374,13.973,5.076,2203777,72.6,70.3,1600216,1549881,50335,3.1
Iowa,1998,1195305,58611,42284,3.538,21.282,6658,9.163,6024,8.29,72982,3989,4083,21029,49839,119639,169478,14.179,4.17,87295,127194,39899,10.641,3.338,2213630,72,70,1594041,1548820,45221,2.8
Iowa,1999,1231319,58457,27255,2.213,24.123,6438,8.797,6131,8.377,73340,4235,4351,24491,58302,117471,175773,14.275,4.735,99103,148518,49415,12.062,4.013,2224318,71.6,69.7,1593440,1550993,42447,2.7
Iowa,2000,1264050,58317,27372,2.165,22.173,6164,8.393,6072,8.268,73490,4097,4230,23277,55868,111644,167512,13.252,4.42,92742,140140,47398,11.087,3.75,2233091,71.4,69.5,1594400,1551434,42966,2.7
Iowa,2001,1256142,57525,-24379,-1.941,22.761,5948,8.13,6717,9.181,72776,4264,4416,24176,47527,95430,142957,11.381,3.784,116512,167336,50824,13.321,4.046,2240136,71.9,69.5,1610634,1556923,53711,3.3
Iowa,2002,1242695,57283,-25897,-2.084,26.124,6818,9.353,7035,9.651,72787,4046,4187,31138,64176,98142,162318,13.062,5.164,128312,188215,59903,15.146,4.82,2246553,72.5,69.6,1629047,1564178,64869,4
Iowa,2003,1227831,57593,-2672,-0.218,25.159,6791,9.316,6511,8.932,73038,3844,3931,21034,53519,100936,154455,12.58,4.359,108756,157127,48371,12.797,3.94,2253298,71.4,68.2,1607931,1536505,71426,4.4
Iowa,2004,1234065,58006,16665,1.35,23.111,6526,8.907,6080,8.298,73490,3909,3991,21433,47182,112086,159268,12.906,3.823,95088,142603,47515,11.556,3.85,2263148,71,67.8,1607438,1534634,72804,4.5
Iowa,2005,1252987,58323,21290,1.699,21.471,6568,8.906,6054,8.209,74006,4047,4132,21376,50529,105273,155802,12.434,4.033,94129,134512,40383,10.735,3.223,2275361,71.6,68.5,1628510,1558522,69988,4.3
Iowa,2006,1281912,58243,35321,2.755,20.751,7741,10.389,6731,9.033,75019,4632,4729,21541,58550,109777,168327,13.131,4.567,95371,133006,37635,10.376,2.936,2291210,72.3,69.6,1655924,1595344,60580,3.7
Iowa,2007,1297260,58232,-2698,-0.208,24.912,6762,9,6495,8.645,75267,4136,4200,23223,48472,113114,161586,12.456,3.736,113859,164284,50425,12.664,3.887,2306017,72.1,69.4,1662155,1600507,61648,3.7
Iowa,2008,1301238,57576,13297,1.022,22.797,6081,8.113,6638,8.856,74677,4252,4337,23052,44114,117507,161621,12.421,3.39,103544,148324,44780,11.399,3.441,2319607,72.5,69.5,1682209,1612459,69750,4.1
Iowa,2009,1292525,56779,-30285,-2.343,21.62,5395,7.247,6330,8.503,73973,4216,4277,24675,43666,96059,139725,10.81,3.378,130090,170010,39920,13.153,3.089,2333606,71.9,67.3,1677059,1569561,107498,6.4
Iowa,2010,1262179,56362,-29540,-2.34,19.38,5489,7.43,5708,7.727,73762,3556,3632,24336,37269,85034,122303,9.69,2.953,109502,151843,42341,12.03,3.355,2358177,71,66.7,1674411,1571960,102451,6.1
Iowa,2011,1251273,55913,10744,0.859,19.73,5523,7.501,5784,7.856,73499,3649,3722,18965,38465,95717,134182,10.724,3.074,87472,123438,35966,9.865,2.874,2375851,70.3,66.3,1670056,1575767,94289,5.6
Iowa,2012,1270653,56136,24710,1.945,19.597,5741,7.798,5453,7.406,73769,3329,3402,18272,37367,111850,149217,11.743,2.941,85412,124507,39095,9.799,3.077,2389698,69.5,66,1660180,1576236,83944,5.1
Iowa,2013,1289962,55598,14991,1.162,18.889,5393,7.324,5635,7.653,73514,3435,3481,16752,39804,97019,136823,10.607,3.086,89368,121832,32464,9.445,2.517,2405163,69.7,66.4,1676565,1597139,79426,4.7
Iowa,2014,1301483,55493,7829,0.602,17.856,5264,7.158,5229,7.111,73554,3327,3423,17844,36918,87110,124028,9.53,2.837,80853,116199,35346,8.928,2.716,2420070,70.2,67.2,1698718,1626676,72042,4.2
Iowa,2015,1320827,55740,30711,2.325,17.16,5723,7.748,5188,7.024,74128,3238,3317,16611,42845,101191,144036,10.905,3.244,80104,113325,33221,8.58,2.515,2431480,69.9,67.3,1700549,1637467,63082,3.7
Iowa,2016,1344451,55942,18460,1.373,17.604,5837,7.83,5014,6.726,74962,3254,3328,17900,39714,97086,136800,10.175,2.954,86803,118340,31537,8.802,2.346,2442456,69.7,67.2,1703164,1642152,61012,3.6
Iowa,2017,1352421,55874,4,0,21.786,5674,7.572,5711,7.622,74914,3354,3412,18376,39821,107502,147323,10.893,2.944,105327,147319,41992,10.893,3.105,2465307,68.9,66.8,1697495,1645660,51835,3.1
Iowa,2018,1360429,56312,15066,1.107,19.262,5828,7.753,5261,6.998,75457,3272,3403,19326,39295,106794,146089,10.738,2.888,94991,131023,36032,9.631,2.649,2474800,69.2,67.4,1711811,1667817,43994,2.6
Iowa,2019,1376146,56173,21888,1.591,17.532,5469,7.244,5426,7.187,75516,3595,3677,20770,35204,107319,142523,10.357,2.558,85426,120635,35209,8.766,2.559,2487544,70,68.2,1742078,1695474,46604,2.7
Iowa,2020,1389545,55958,5895,0.424,18.772,5757,7.625,5763,7.633,75503,3592,3678,18701,40800,95521,136321,9.81,2.936,93993,130426,36433,9.386,2.622,2493481,66.9,63.5,1668401,1582202,86199,5.2
Iowa,2021,1372436,56288,-41322,-3.011,18.471,6321,8.363,6180,8.177,75649,3592,3702,17053,39175,87578,126753,9.236,2.854,127795,168075,40280,12.246,2.935,2502431,67.1,64.5,1679982,1615303,64679,3.8
Iowa,2022,1366696,56374,34396,2.517,21.605,6439,8.521,6572,8.697,75497,4242,4500,21998,50001,132031,182032,13.319,3.659,100815,147636,46821,10.802,3.426,2510412,68,66.1,1706493,1658263,48230,2.8
Kansas,1978,691344,46065,42512,6.149,28.11,7384,13.962,5652,10.687,53751,4000,4042,22000,48184,91498,139682,20.204,6.97,59187,97170,37983,14.055,5.494,1697750,66.9,64.9,1135822,1101149,34673,3.1
Kansas,1979,738763,47414,48628,6.582,24.463,7035,12.884,5618,10.289,55309,4018,4067,19811,44404,94584,138988,18.814,6.011,57350,90360,33010,12.231,4.468,1719250,67.6,65.5,1161492,1125486,36006,3.1
Kansas,1980,767181,47642,7954,1.037,28.773,6346,11.437,6050,10.904,55633,4460,4502,20494,40526,77799,118325,15.423,5.282,78545,110371,31826,14.387,4.148,1739250,67.8,64.8,1179558,1127524,52034,4.4
Kansas,1981,778315,47823,11860,1.524,29.888,6705,12.005,6179,11.063,56114,4541,4604,21304,47140,81033,128173,16.468,6.057,81040,116313,35273,14.944,4.532,1755333,67.3,64.4,1181689,1130646,51043,4.3
Kansas,1982,778612,47344,-17418,-2.237,28.803,6591,11.772,6872,12.274,55846,5014,5073,27502,40704,71428,112132,14.402,5.228,89005,129550,40545,16.639,5.207,1770917,67.4,63.2,1193636,1118398,75238,6.3
Kansas,1983,750451,48121,-39247,-5.23,28.646,6909,12.286,6180,10.99,56597,4390,4460,21640,37878,69610,107488,14.323,5.047,97602,146735,49133,19.553,6.547,1784417,66.9,63,1194270,1123813,70457,5.9
Kansas,1984,759948,49912,59412,7.818,25.792,8039,13.959,6059,10.521,58582,4427,4474,23896,61128,96287,157415,20.714,8.044,60259,98003,37744,12.896,4.967,1795333,67.1,63.8,1204362,1144575,59787,5
Kansas,1985,796981,49789,18319,2.299,29.793,7076,12.093,7184,12.277,58460,5231,5318,30888,49791,87251,137042,17.195,6.247,64211,118723,54512,14.897,6.84,1794083,68.6,65.1,1230529,1167067,63462,5.2
Kansas,1986,815121,49549,14583,1.789,29.094,7150,12.223,7099,12.136,58521,5239,5343,26475,49029,84131,133160,16.336,6.015,76082,118577,42495,14.547,5.213,1815417,68.8,65.1,1249332,1182678,66654,5.3
Kansas,1987,798646,49239,-2887,-0.361,35.552,7129,12.194,7243,12.389,58405,4983,5070,26636,63439,78528,141967,17.776,7.943,94591,144854,50263,18.137,6.294,1831583,69,65.7,1264347,1203518,60829,4.8
Kansas,1988,811140,50002,20222,2.493,29.782,7475,12.643,6207,10.498,59759,4384,4470,27753,58279,82729,141008,17.384,7.185,75726,120786,45060,14.891,5.555,1845667,69.1,66,1275408,1218029,57379,4.5
Kansas,1989,841630,50151,49719,5.907,27.811,6938,11.574,6561,10.945,60135,4769,4867,26836,75418,91332,166750,19.813,8.961,73492,117031,43539,13.905,5.173,1853500,69,66.2,1279617,1226451,53166,4.2
Kansas,1990,879451,50071,24849,2.826,25.825,6571,10.918,6504,10.807,60217,4727,4835,25424,47650,90760,138410,15.738,5.418,72776,113561,40785,12.913,4.638,1823499,69.8,66.8,1272578,1218561,54017,4.2
Kansas,1991,889914,49680,-3445,-0.387,30.414,6952,11.533,6649,11.03,60430,4640,4805,30867,55455,79873,135328,15.207,6.232,90408,138773,48365,15.594,5.435,1834219,70.1,67,1285549,1228183,57366,4.5
Kansas,1992,891774,49953,8670,0.972,29.067,6667,10.992,6060,9.991,60959,3979,4049,24702,50293,87982,138275,15.506,5.64,87679,129605,41926,14.533,4.701,1857694,70.5,67.3,1310475,1250711,59764,4.6
Kansas,1993,903521,50967,15635,1.73,25.383,6538,10.642,5578,9.08,61915,3720,3802,20719,39281,91025,130306,14.422,4.348,80745,114671,33926,12.692,3.755,1879835,70.7,67.2,1328417,1262698,65719,4.9
Kansas,1994,927788,52030,29099,3.136,24.627,7006,11.193,5829,9.313,63180,4050,4207,22810,48846,94495,143341,15.45,5.265,75650,114242,38592,12.313,4.16,1899227,70.9,67.5,1346332,1281897,64435,4.8
Kansas,1995,957275,52891,29394,3.071,22.918,6935,10.876,5730,8.987,64364,4078,4171,21798,48388,90699,139087,14.529,5.055,72985,109693,36708,11.459,3.835,1920869,70.5,67.4,1354129,1295252,58877,4.3
Kansas,1996,977267,53220,30443,3.115,24.66,6945,10.761,5956,9.228,65036,4263,4371,25500,55025,95916,150941,15.445,5.631,79083,120498,41415,12.33,4.238,1940011,70.5,67.5,1367812,1309635,58177,4.3
Kansas,1997,1011239,53703,31130,3.078,27.512,7376,11.272,6608,10.099,65819,4342,4436,25320,61920,108316,170236,16.834,6.123,88905,139106,50201,13.756,4.964,1956819,70.6,67.9,1380868,1328415,52453,3.8
Kansas,1998,1060172,54392,33768,3.185,25.968,7021,10.552,6275,9.431,66907,4185,4314,24696,59760,111659,171419,16.169,5.637,88356,137651,49295,12.984,4.65,1974711,70.9,68.2,1399168,1347503,51665,3.7
Kansas,1999,1086842,54423,21979,2.022,27.542,6723,10.026,6421,9.575,67209,4227,4344,25254,60940,110708,171648,15.793,5.607,89837,149669,59832,13.771,5.505,1989686,70.7,68.2,1406631,1357493,49138,3.5
Kansas,2000,1108590,54473,21916,1.977,26.28,6741,10.002,6414,9.517,67560,4195,4293,23561,62122,105464,167586,15.117,5.604,97004,145670,48666,13.14,4.39,2001406,70.1,67.4,1402606,1349841,52765,3.8
Kansas,2001,1117695,54123,-17699,-1.584,26.34,6669,9.882,6869,10.178,67388,4360,4478,25437,52784,94416,147200,13.17,4.723,108085,164899,56814,14.753,5.083,2014243,69.4,66.5,1398521,1338775,59746,4.3
Kansas,2002,1107993,54016,-15720,-1.419,31.375,7391,10.922,7248,10.71,67744,4336,4472,31547,73275,100543,173818,15.688,6.613,128663,189538,60875,17.106,5.494,2028297,70,66.4,1419335,1347163,72172,5.1
Kansas,2003,1105309,54326,5754,0.521,27.806,6924,10.199,6518,9.601,68093,4091,4177,25158,59707,99718,159425,14.424,5.402,101667,153671,52004,13.903,4.705,2041137,70.6,66.7,1441065,1361115,79950,5.5
Kansas,2004,1112249,55035,8337,0.75,25.186,6903,10.086,6139,8.97,68822,3942,4026,22608,52913,95489,148402,13.343,4.757,95637,140065,44428,12.593,3.994,2052157,71.1,67.2,1458910,1378355,80555,5.5
Kansas,2005,1120905,55445,6157,0.549,25.777,6795,9.83,6198,8.966,69425,4110,4198,22921,49788,100835,150623,13.438,4.442,94670,144466,49796,12.888,4.442,2067011,70.6,67,1458767,1384654,74113,5.1
Kansas,2006,1144780,55599,31938,2.79,23.496,7524,10.786,6816,9.771,70114,4606,4705,22539,58071,108357,166428,14.538,5.073,91227,134490,43263,11.748,3.779,2080118,70.6,67.4,1467553,1402950,64603,4.4
Kansas,2007,1170662,55679,18365,1.569,26.319,7136,10.147,6674,9.49,70554,4258,4335,24640,62674,109746,172420,14.728,5.354,105148,154055,48907,13.16,4.178,2096349,70.9,67.8,1485414,1422109,63305,4.3
Kansas,2008,1184934,55082,11704,0.988,24.478,6159,8.765,6675,9.499,70009,4311,4415,24026,43773,112955,156728,13.227,3.694,101232,145024,43792,12.239,3.696,2111166,70.7,67.5,1493365,1425022,68343,4.6
Kansas,2009,1174626,54166,-37042,-3.154,21.457,5501,7.895,6581,9.445,69140,4318,4445,23352,40074,85945,126019,10.728,3.412,122014,163061,41047,13.882,3.494,2128661,71.1,66.2,1512572,1408142,104430,6.9
Kansas,2010,1140975,53450,-33045,-2.896,21.029,5419,7.872,6064,8.809,68515,3863,3943,21098,39310,80658,119968,10.515,3.445,110757,153013,42256,13.411,3.703,2148695,69.8,65,1500463,1396172,104291,7
Kansas,2011,1124579,52631,50,0.004,23.698,5677,8.312,6102,8.934,68086,3989,4061,20204,46042,87260,133302,11.854,4.094,94000,133252,39252,11.849,3.49,2161752,69.3,64.9,1498000,1402198,95802,6.4
Kansas,2012,1134477,52567,20983,1.85,21.821,5704,8.383,5751,8.452,68021,3449,3590,19288,43973,100785,144758,12.76,3.876,85518,123775,38257,10.91,3.372,2174287,68.6,64.6,1490808,1405638,85170,5.7
Kansas,2013,1151049,52193,16817,1.461,21.471,5445,8.025,5738,8.457,67704,3548,3581,19902,40928,99460,140388,12.197,3.556,84420,123571,39151,10.736,3.401,2183614,68.2,64.6,1489395,1410470,78925,5.3
Kansas,2014,1168688,52351,19335,1.654,21.663,5697,8.39,5320,7.835,68090,3358,3435,18392,47681,98238,145919,12.486,4.08,85583,126584,41001,10.831,3.508,2194460,68.1,65,1494203,1426892,67311,4.5
Kansas,2015,1184253,52365,14619,1.234,22.984,5791,8.483,5421,7.941,68450,3470,3581,19389,49573,101138,150711,12.726,4.186,98541,136092,37551,11.492,3.171,2204743,67.8,64.9,1493782,1431533,62249,4.2
Kansas,2016,1190176,52566,-2108,-0.177,22.178,6072,8.817,5254,7.629,69275,3433,3558,23672,45930,86049,131979,11.089,3.859,87832,134087,46255,11.266,3.886,2213994,67.4,64.7,1491961,1431920,60041,4
Kansas,2017,1191017,52231,11608,0.975,23.163,5629,8.144,5921,8.567,68972,3678,3780,22114,48276,101270,149546,12.556,4.053,90885,137938,47053,11.582,3.951,2227730,66.8,64.4,1488346,1434516,53830,3.6
Kansas,2018,1197143,52001,-1378,-0.115,22.82,5266,7.662,5584,8.125,68566,3569,3661,19995,38611,97982,136593,11.41,3.225,98228,137971,39743,11.525,3.32,2233869,66.9,64.6,1493360,1443204,50156,3.4
Kansas,2019,1201582,51790,13289,1.106,20.173,5440,7.933,5411,7.89,68591,3614,3739,21025,41362,93126,134488,11.193,3.442,83197,121199,38002,10.087,3.163,2240796,67.1,65,1504415,1456662,47753,3.2
Kansas,2020,1206567,51359,-7185,-0.595,21.787,5378,7.859,5687,8.311,68273,3599,3672,22606,39836,91600,131436,10.893,3.302,94777,138621,43844,11.489,3.634,2247017,66.8,63,1501827,1414596,87231,5.8
Kansas,2021,1200046,52031,-11068,-0.922,24.342,6177,9.004,5515,8.039,68936,3414,3556,18687,41156,104899,146055,12.171,3.43,121001,157123,36122,13.093,3.01,2252872,66.5,64.3,1498226,1448294,49932,3.3
Kansas,2022,1209224,52278,27824,2.301,23.186,6270,9.078,5991,8.674,69206,3985,4101,21127,41255,126752,168007,13.894,3.412,99983,140183,40200,11.593,3.324,2259490,66.5,64.7,1502603,1463010,39593,2.6
Kentucky,1978,891063,51346,62251,6.986,26.84,8657,14.624,6776,11.446,60138,4762,4826,22083,59874,121958,181832,20.406,6.719,75563,119581,44018,13.42,4.94,2581583,61.1,58,1577833,1497930,79903,5.1
Kentucky,1979,955617,53031,51310,5.369,25.764,8378,13.669,6389,10.424,62288,4617,4649,21958,59092,115321,174413,18.251,6.184,82686,123103,40417,12.882,4.229,2619667,61.6,58.2,1612872,1523536,89336,5.5
Kentucky,1980,967498,52762,-22869,-2.364,26.854,7185,11.534,7158,11.491,62307,5322,5365,25408,47095,82811,129906,13.427,4.868,111859,152775,40916,15.791,4.229,2649750,62.7,57.7,1661498,1528256,133242,8
Kentucky,1981,959919,52494,-5915,-0.616,28.626,7115,11.43,7154,11.493,62229,5267,5316,25476,51617,85777,137394,14.313,5.377,100925,143309,42384,14.929,4.415,2674750,62.3,57,1667409,1523608,143801,8.6
Kentucky,1982,948894,51884,-18242,-1.922,29.034,7404,11.925,7704,12.408,61938,5671,5709,26819,54360,83393,137753,14.517,5.729,112001,155995,43994,16.44,4.636,2697250,62.4,55.7,1683779,1501595,182184,10.8
Kentucky,1983,926478,52096,-25433,-2.745,29.637,7710,12.456,7713,12.461,61896,5161,5211,27033,55251,82037,137288,14.818,5.964,103532,162721,59189,17.563,6.389,2720250,62.4,55.4,1696793,1505906,190887,11.2
Kentucky,1984,951935,54828,74919,7.87,24.326,9363,14.746,6166,9.711,65095,4678,4743,27126,90367,100338,190705,20.033,9.493,77301,115786,38485,12.163,4.043,2731417,62.4,56.7,1703374,1549090,154284,9.1
Kentucky,1985,1006817,55306,39080,3.882,25.472,8298,12.703,7830,11.987,65556,5761,5856,31090,57769,109540,167309,16.618,5.738,75482,128229,52747,12.736,5.239,2745500,61.9,56.3,1698511,1545506,153005,9
Kentucky,1986,1040381,56177,29370,2.823,26.842,8758,13.229,7422,11.211,66873,5434,5490,28455,61956,107044,169000,16.244,5.955,91914,139630,47716,13.421,4.586,2760417,61.8,56.1,1704885,1547356,157529,9.2
Kentucky,1987,1076843,57033,-36098,-3.352,34.145,8973,13.292,7712,11.424,68137,5406,5511,35041,71411,112435,183846,17.073,6.632,155716,219944,64228,20.425,5.964,2774583,61.4,56.3,1702424,1561567,140857,8.3
Kentucky,1988,1077942,57935,42824,3.973,28.386,9071,13.156,7565,10.972,69703,5406,5487,31198,75188,120630,195818,18.166,6.975,96385,152994,56609,14.193,5.252,2788667,61.5,56.9,1714898,1587089,127809,7.5
Kentucky,1989,1123709,59035,49917,4.442,26.291,8971,12.725,7440,10.553,71265,5361,5457,32475,69006,128630,197636,17.588,6.141,89889,147719,57830,13.146,5.146,2796750,62.2,58.3,1740171,1629579,110592,6.4
Kentucky,1990,1171338,59913,37511,3.202,26.078,8698,12.097,7438,10.345,72530,5486,5572,31887,68214,122029,190243,16.242,5.824,100342,152732,52390,13.039,4.473,2798751,62.7,58.9,1754564,1648594,105970,6
Kentucky,1991,1189434,59466,-3029,-0.255,30.301,8536,11.723,7822,10.742,73174,5732,5832,38478,72398,107810,180208,15.151,6.087,123035,183237,60202,15.405,5.061,2827754,62.2,57.7,1759884,1631038,128846,7.3
Kentucky,1992,1194351,59622,17880,1.497,26.689,8068,11.001,7622,10.393,73562,5232,5328,30229,59131,118130,177261,14.842,4.951,107859,159381,51522,13.345,4.314,2856435,62.2,57.9,1777326,1654836,122490,6.9
Kentucky,1993,1224392,60833,39024,3.187,24.921,8270,11.152,7068,9.531,74756,4832,4944,27203,64316,127275,191591,15.648,5.253,103219,152567,49348,12.461,4.03,2894782,62.2,58.3,1800303,1689090,111213,6.2
Kentucky,1994,1265601,61870,35348,2.793,24.945,8217,10.877,6920,9.16,76195,4895,4994,31895,64403,128794,193197,15.265,5.089,106534,157849,51315,12.472,4.055,2924296,62.5,59.2,1828635,1730427,98208,5.4
Kentucky,1995,1311617,63154,58942,4.494,23.271,8737,11.332,6906,8.957,78017,4894,4995,29674,72547,139007,211554,16.129,5.531,99768,152612,52844,11.635,4.029,2956394,62.8,59.4,1856613,1756619,99994,5.4
Kentucky,1996,1340210,63522,14854,1.108,27.22,8631,11.016,7374,9.412,78975,5237,5358,33235,75825,121434,197259,14.719,5.658,123893,182405,58512,13.61,4.366,2986241,62.7,59.3,1873508,1771831,101677,5.4
Kentucky,1997,1374466,64126,49928,3.633,27.314,9024,11.35,7987,10.046,80025,5340,5487,35467,81930,155706,237636,17.289,5.961,121076,187708,66632,13.657,4.848,3005922,63.6,60.2,1910330,1810893,99437,5.2
Kentucky,1998,1431822,64933,39962,2.791,26.991,8710,10.766,7396,9.142,81562,5017,5107,29492,86743,146447,233190,16.286,6.058,133861,193228,59367,13.495,4.146,3034769,63.4,60.5,1923021,1836351,86670,4.5
Kentucky,1999,1454005,65124,10389,0.715,28.142,8413,10.287,7895,9.653,82043,5204,5361,32596,78627,136358,214985,14.786,5.408,140942,204596,63654,14.071,4.378,3062200,63.6,60.7,1947152,1859690,87462,4.5
Kentucky,2000,1487734,64843,47079,3.164,24.368,8031,9.775,7881,9.593,82230,5171,5307,33477,75096,153250,228346,15.349,5.048,120214,181267,61053,12.184,4.104,3086153,63.4,60.8,1957400,1876232,81168,4.1
Kentucky,2001,1499930,64674,-24740,-1.649,26.763,7969,9.704,8168,9.946,82020,5050,5243,33645,67764,132950,200714,13.382,4.518,149066,225454,76388,15.031,5.093,3106382,62.9,59.6,1953834,1852043,101791,5.2
Kentucky,2002,1478590,64539,-29023,-1.963,29.68,8832,10.707,8341,10.112,82730,5088,5213,35212,84121,135303,219424,14.84,5.689,175266,248447,73181,16.803,4.949,3129417,62.1,58.5,1944682,1832250,112432,5.8
Kentucky,2003,1464743,64570,1112,0.076,28.001,8001,9.657,7692,9.284,83006,4963,5104,30831,67860,138325,206185,14.077,4.633,140072,205073,65001,14.001,4.438,3156144,62.3,58.4,1965881,1844378,121503,6.2
Kentucky,2004,1476099,65206,19020,1.289,25.658,8170,9.796,7379,8.848,83796,4785,4935,34500,70124,138262,208386,14.117,4.751,120866,189366,68500,12.829,4.641,3176063,62,58.6,1969935,1861750,108185,5.5
Kentucky,2005,1499800,65584,23543,1.57,25.232,8292,9.851,7569,8.992,84534,5072,5179,30019,68256,144505,212761,14.186,4.551,133783,189218,55435,12.616,3.696,3207183,62.1,58.5,1991726,1874747,116979,5.9
Kentucky,2006,1528896,65963,35554,2.325,24,8941,10.5,7655,8.989,85799,5252,5343,29461,74310,144715,219025,14.326,4.86,125478,183471,57993,12,3.793,3245865,62.4,58.9,2026144,1910580,115564,5.7
Kentucky,2007,1544682,65882,-7034,-0.455,28.355,8671,10.084,8160,9.49,86240,5265,5344,33053,76918,142076,218994,14.177,4.98,161710,226028,64318,14.633,4.164,3274539,62.2,58.8,2035493,1925716,109777,5.4
Kentucky,2008,1539470,64829,-2716,-0.176,26.404,7528,8.767,8291,9.655,85488,5505,5609,35866,64003,139239,203242,13.202,4.157,139332,205958,66626,13.379,4.328,3307860,61.6,57.6,2038225,1906275,131950,6.5
Kentucky,2009,1506974,63433,-74155,-4.921,22.214,6855,8.064,8385,9.863,84247,5459,5614,34173,61878,105501,167379,11.107,4.106,177608,241534,63926,16.028,4.242,3328976,62,55.3,2064847,1842085,222762,10.8
Kentucky,2010,1455623,62493,-28095,-1.93,22.765,6711,8.003,7522,8.97,83450,4819,4964,28691,57042,108646,165688,11.383,3.919,143046,193783,50737,13.313,3.486,3350086,61.6,55.3,2065023,1852302,212721,10.3
Kentucky,2011,1444532,61687,6635,0.459,23.087,6804,8.178,7279,8.749,82964,4858,5024,29254,51382,122004,173386,12.003,3.557,114392,166751,52359,11.544,3.625,3371493,61.1,55.4,2061500,1868168,193332,9.4
Kentucky,2012,1463872,61613,32490,2.219,22.612,7021,8.459,6907,8.322,83057,4243,4386,23064,58122,139877,197999,13.526,3.97,113940,165509,51569,11.306,3.523,3389583,60.8,55.8,2060084,1891109,168975,8.2
Kentucky,2013,1492855,61723,23224,1.556,22.724,7332,8.81,6917,8.312,83427,4316,4382,25146,62950,129892,192842,12.918,4.217,118118,169618,51500,11.362,3.45,3411413,60.3,55.5,2055895,1892777,163118,7.9
Kentucky,2014,1519336,62191,29665,1.952,22.298,7763,9.248,6781,8.078,84431,4287,4387,24199,67360,131694,199054,13.101,4.434,120824,169389,48565,11.149,3.196,3427723,58.5,54.8,2006518,1877551,128967,6.4
Kentucky,2015,1556088,62218,42467,2.729,19.501,7334,8.649,6644,7.835,85140,4284,4355,23600,57550,136647,194197,12.48,3.698,106489,151730,45241,9.751,2.907,3443534,57.5,54.5,1979641,1876009,103632,5.2
Kentucky,2016,1591337,62239,28148,1.769,20.373,7065,8.273,6535,7.652,85662,4346,4535,24930,57082,133164,190246,11.955,3.587,113915,162098,48183,10.186,3.028,3459892,58.3,55.3,2015645,1914479,101166,5
Kentucky,2017,1609631,61799,19236,1.195,23.463,6905,8.083,7355,8.61,85199,4706,4766,32142,63555,144515,208070,12.927,3.948,121780,188834,67054,11.732,4.166,3489934,58.8,56,2053398,1955234,98164,4.8
Kentucky,2018,1627751,60798,16912,1.039,21.665,6413,7.608,6775,8.038,84111,4248,4376,28288,58987,134252,193239,11.872,3.624,121863,176327,54464,10.833,3.346,3502248,58.6,56.1,2052877,1966186,86691,4.2
Kentucky,2019,1652948,61114,32540,1.969,19.412,6851,8.117,6195,7.34,84734,4080,4201,24464,60779,132198,192977,11.675,3.677,111150,160437,49287,9.706,2.982,3515061,58.7,56.3,2064637,1979803,84834,4.1
Kentucky,2020,1667729,60428,-7862,-0.471,21.088,6498,7.684,6824,8.07,84401,4312,4438,28714,54379,121469,175848,10.544,3.261,124461,183710,59249,11.016,3.553,3519510,57,53.3,2005210,1874863,130347,6.5
Kentucky,2021,1650533,60510,-31407,-1.903,23.952,7789,9.207,7351,8.689,84822,4271,4495,25759,78226,119442,197668,11.976,4.739,168524,229075,60551,13.879,3.669,3521417,57.1,54.6,2010884,1921355,89529,4.5
Kentucky,2022,1648347,61137,29885,1.813,25.398,8193,9.615,7358,8.635,85626,4746,4930,44287,63839,175372,239211,14.512,3.873,133616,209326,75710,12.699,4.593,3527613,57.6,55.2,2030274,1948312,81962,4
Louisiana,1978,1108594,61295,130741,11.793,27.019,11061,15.518,8024,11.257,72799,5710,5772,28232,88451,192057,280508,25.303,7.979,94641,149767,55126,13.51,4.973,2836500,58.8,54.8,1668892,1554999,113893,6.8
Louisiana,1979,1205195,64302,82468,6.843,29.572,11481,15.39,7969,10.682,76357,5814,5876,36666,88699,171969,260668,21.629,7.36,115215,178200,62985,14.786,5.226,2905500,59.3,55.3,1722092,1607615,114477,6.6
Louisiana,1980,1252550,65211,17326,1.383,32.48,10371,13.479,9082,11.803,77588,6679,6737,37350,71907,148835,220742,17.623,5.741,143060,203416,60356,16.24,4.819,2980667,59.6,55.4,1776751,1651578,125173,7
Louisiana,1981,1293061,66834,67847,5.247,29.017,11214,14.26,8931,11.357,79781,6552,6640,35639,89677,165775,255452,19.756,6.935,124258,187605,63347,14.509,4.899,3045333,60.6,55.5,1846264,1690543,155721,8.4
Louisiana,1982,1331983,68188,11559,0.868,36.505,11476,14.204,9567,11.841,81747,7050,7125,44976,91019,163661,254680,19.12,6.833,164914,243121,78207,18.253,5.871,3108667,60.1,53.9,1867187,1676469,190718,10.2
Louisiana,1983,1290341,69688,-100200,-7.765,32.727,11210,13.596,9832,11.925,83139,7065,7155,45949,76835,134312,211147,16.364,5.955,224175,311347,87172,24.129,6.756,3163167,60.4,53.4,1910265,1689628,220637,11.6
Louisiana,1984,1253202,71680,31437,2.509,32.636,12496,14.808,10030,11.886,85621,7431,7556,39869,89535,146399,235934,18.827,7.145,134924,204497,69573,16.318,5.552,3184917,60.8,54.6,1937773,1740032,197741,10.2
Louisiana,1985,1266268,71332,-3747,-0.296,35.75,11379,13.316,11685,13.674,85303,8677,8829,55403,82074,144273,226347,17.875,6.482,141449,230094,88645,18.171,7,3199250,61.6,54.5,1970579,1744815,225764,11.5
Louisiana,1986,1252758,70258,-29105,-2.323,34.968,11175,13.144,11760,13.832,84726,8853,8975,51395,88187,130843,219030,17.484,7.039,166176,248135,81959,19.807,6.542,3219417,61.3,53.6,1973584,1726659,246925,12.5
Louisiana,1987,1212568,67111,-64774,-5.342,34.463,10179,12.242,13315,16.013,81583,9265,9407,59890,92750,116195,208945,17.232,7.649,164177,273719,109542,22.573,9.034,3196750,61,53.8,1950906,1720228,230678,11.8
Louisiana,1988,1181560,66065,14009,1.186,34.984,10329,12.696,10904,13.403,81070,7544,7707,45983,85557,135130,220687,18.678,7.241,127547,206678,79131,17.492,6.697,3169833,60.8,54.3,1926370,1722504,203866,10.6
Louisiana,1989,1203279,65252,31223,2.595,31.799,9355,11.59,10119,12.537,80333,7011,7206,47893,77898,144642,222540,18.494,6.474,113787,191317,77530,15.9,6.443,3155667,59.8,55.1,1887656,1739003,148653,7.9
Louisiana,1990,1247305,65680,57307,4.594,28.215,9535,11.817,8873,10.996,81021,6331,6480,41629,80138,153134,233272,18.702,6.425,110516,175965,65449,14.108,5.247,3072687,60.8,57,1866683,1750348,116335,6.2
Louisiana,1991,1288973,65698,20701,1.606,32.172,9881,12.125,8777,10.77,82045,6174,6347,47329,86572,141476,228048,17.692,6.716,130077,207347,77270,16.086,5.995,3097061,61.5,57.1,1904952,1767256,137696,7.2
Louisiana,1992,1298263,66257,12154,0.936,33.147,9356,11.368,8618,10.471,82673,5568,5712,40537,74832,152487,227319,17.509,5.764,138771,215165,76394,16.573,5.884,3119233,61.7,56.9,1924722,1773741,150981,7.8
Louisiana,1993,1314790,67931,21033,1.6,30.557,9321,11.168,7725,9.256,84261,5299,5400,38853,70943,150970,221913,16.878,5.396,135691,200880,65189,15.278,4.958,3143405,60.7,56.2,1909259,1767116,142143,7.4
Louisiana,1994,1353696,69397,53528,3.954,27.563,10043,11.776,8190,9.603,86208,5659,5881,35849,89668,150420,240088,17.736,6.624,127684,186560,58876,13.782,4.349,3166244,61.6,56.9,1951910,1802514,149396,7.7
Louisiana,1995,1394368,70683,34913,2.504,29.473,9823,11.288,8163,9.38,87854,5678,5907,40682,89934,150458,240392,17.24,6.45,126971,205479,78508,14.736,5.63,3192666,61.5,57.3,1963728,1829047,134681,6.9
Louisiana,1996,1421115,71703,40377,2.841,27.344,9700,10.973,8020,9.073,89237,5693,5819,36439,78694,155975,234669,16.513,5.537,133164,194292,61128,13.672,4.301,3219755,61.8,57.8,1989419,1860721,128698,6.5
Louisiana,1997,1460859,72511,35886,2.457,31.417,10253,11.419,9219,10.268,90303,6160,6323,41831,90238,175128,265366,18.165,6.177,147421,229480,82059,15.709,5.617,3244010,61.9,58.2,2007671,1889325,118346,5.9
Louisiana,1998,1541179,73412,49939,3.24,28.486,9744,10.695,8780,9.636,91594,5841,6029,42028,90083,179363,269446,17.483,5.845,145585,219507,73922,14.243,4.796,3262933,62.2,58.7,2029167,1916965,112202,5.5
Louisiana,1999,1571278,73219,2806,0.179,30.396,9291,10.131,9095,9.918,91803,6046,6262,49104,79281,162331,241612,15.377,5.046,153200,238806,85606,15.198,5.448,3280605,61.7,58.7,2025623,1925041,100582,5
Louisiana,2000,1585224,72779,22169,1.398,30.08,9378,10.201,9208,10.016,92018,6002,6213,49675,99509,161079,260588,16.439,6.277,154403,238419,84016,15.04,5.3,3289644,61.6,58.4,2026392,1921984,104408,5.2
Louisiana,2001,1591734,72572,-9873,-0.62,29.859,9303,10.129,9626,10.481,91684,5714,5923,41557,80427,157214,237641,14.93,5.053,161424,247514,86090,15.55,5.409,3296432,61.5,58,2027220,1913555,113665,5.6
Louisiana,2002,1584861,73073,-23191,-1.463,32.619,10182,11.025,9329,10.102,92777,5654,5874,48098,104167,154312,258479,16.309,6.573,187688,281670,93982,17.773,5.93,3309707,60.8,57.2,2013652,1892947,120705,6
Louisiana,2003,1583895,73683,19226,1.214,28.817,9274,9.97,8713,9.367,93299,5566,5675,38644,78229,169212,247441,15.622,4.939,153265,228215,74950,14.408,4.732,3326118,60.9,57.1,2024914,1897902,127012,6.3
Louisiana,2004,1606353,74510,23148,1.441,27.121,9252,9.867,8294,8.845,94248,5420,5544,36535,74311,166664,240975,15.001,4.626,151147,217827,66680,13.56,4.151,3341006,60.8,57.3,2030415,1914521,115894,5.7
Louisiana,2005,1614475,74674,-7671,-0.475,29.781,9224,9.765,8795,9.311,94673,5739,5911,43310,74818,165585,240403,14.89,4.634,158839,248074,89235,15.366,5.527,3290373,63.2,58.6,2078215,1929492,148723,7.2
Louisiana,2006,1599041,72006,-23917,-1.496,34.283,10430,11.149,12661,13.534,92433,7529,7689,46030,97641,176460,274101,17.142,6.106,196934,298018,101084,18.637,6.322,3198013,62.6,60,2001297,1919476,81821,4.1
Louisiana,2007,1612329,74774,47647,2.955,29.322,11890,12.633,8408,8.933,95860,5235,5316,33530,92264,191765,284029,17.616,5.722,165396,236382,70986,14.661,4.403,3288915,61.6,59.1,2026793,1943648,83145,4.1
Louisiana,2008,1635060,74818,2704,0.165,28.688,9332,9.716,8882,9.248,96268,5780,5871,34155,72487,164749,237236,14.509,4.433,165869,234532,68663,14.344,4.199,3352739,61.6,58.7,2064692,1968676,96016,4.7
Louisiana,2009,1637083,74502,-16257,-0.993,26.045,8509,8.821,8980,9.31,96224,5953,6056,39415,71434,141758,213192,13.023,4.363,161420,229449,68029,14.016,4.156,3388954,61,56.9,2067873,1927200,140673,6.8
Louisiana,2010,1610400,74024,-39578,-2.458,23.093,8196,8.524,8414,8.751,96043,5429,5576,34019,67809,118134,185943,11.546,4.211,168747,225521,56774,14.004,3.525,3437871,60.6,56.1,2084462,1927720,156742,7.5
Louisiana,2011,1599364,73676,17053,1.066,24.068,8463,8.801,8228,8.557,96272,5377,5532,28343,68245,141273,209518,13.1,4.267,140405,192465,52060,12.034,3.255,3477805,59.8,55.4,2080525,1926038,154487,7.4
Louisiana,2012,1618776,73984,27252,1.683,24.236,8606,8.917,8087,8.379,96776,4925,5093,30047,66047,157367,223414,13.801,4.08,139292,196162,56870,12.118,3.513,3502627,59.7,55.6,2089644,1948630,141014,6.7
Louisiana,2013,1652106,74009,41343,2.502,24.25,8154,8.421,8037,8.3,96892,5027,5103,37672,73898,167765,241663,14.628,4.473,126032,200320,74288,12.125,4.497,3525455,59.6,55.8,2101974,1966755,135219,6.4
Louisiana,2014,1690632,74049,25684,1.519,22.182,8219,8.458,7677,7.9,97443,4881,4977,29030,68431,144759,213190,12.61,4.048,128197,187506,59309,11.091,3.508,3546849,60.4,56.6,2141519,2007668,133851,6.3
Louisiana,2015,1708840,73913,10452,0.612,25.061,8372,8.572,7928,8.118,97887,5035,5134,29636,74249,150332,224581,13.142,4.345,158520,214129,55609,12.531,3.254,3568063,60.3,56.5,2150050,2015081,134969,6.3
Louisiana,2016,1706914,73813,-17779,-1.042,23.309,8589,8.74,7825,7.963,98652,5199,5316,33037,72252,126677,198929,11.654,4.233,159931,216708,56777,12.696,3.326,3583947,59.3,55.7,2123690,1994639,129051,6.1
Louisiana,2017,1688621,73585,-13896,-0.823,25.29,7936,8.061,8362,8.494,98231,4981,5085,29977,63529,149994,213523,12.645,3.762,160541,227419,66878,13.468,3.961,3586139,58.8,55.8,2108485,2000487,107998,5.1
Louisiana,2018,1685451,73632,1621,0.096,23.895,7951,8.107,8204,8.365,97947,5051,5249,32535,59388,143603,202991,12.044,3.524,141042,201370,60328,11.948,3.579,3584904,58.9,56,2109741,2007981,101760,4.8
Louisiana,2019,1701923,73837,30667,1.802,20.517,8130,8.281,7683,7.826,98400,5254,5349,33920,69759,135504,205263,12.061,4.099,121523,174596,53073,10.259,3.118,3584852,58.6,55.9,2101749,2004115,97634,4.6
Louisiana,2020,1710046,73201,-13394,-0.783,22.081,7884,8.026,8224,8.372,98062,5154,5262,29505,57638,131159,188797,11.04,3.371,144189,202191,58002,11.824,3.392,3578356,57.3,52.4,2052043,1875244,176799,8.6
Louisiana,2021,1649444,73944,-107679,-6.528,20.211,9180,9.338,8668,8.817,98564,5256,5524,29675,59742,106940,166682,10.105,3.622,215878,274361,58483,16.634,3.546,3563776,57.7,54.5,2056137,1941271,114866,5.6
Louisiana,2022,1621468,74620,27379,1.689,25.675,9436,9.557,9054,9.17,98927,6072,6289,34737,64262,171274,235536,14.526,3.963,127550,208157,80607,12.838,4.971,3544714,58.4,56.2,2068817,1993244,75573,3.7
Maine,1978,301757,19772,24013,7.958,22.677,3316,15.017,2334,10.57,22572,1649,1667,6983,19063,39165,58228,19.296,6.317,21756,34215,12459,11.339,4.129,805333,60.3,56.4,485686,454521,31165,6.4
Maine,1979,313673,20369,14369,4.581,24.111,3017,13.141,2344,10.209,23296,1709,1722,6786,17342,34842,52184,16.636,5.529,25777,37815,12038,12.056,3.838,818417,61,56.9,499121,466066,33055,6.6
Maine,1980,321335,20282,1666,0.518,27.094,2646,11.363,2701,11.599,23259,1925,1943,8682,13837,31360,45197,14.065,4.306,28353,43531,15178,13.547,4.723,826083,61.3,56.7,506337,468653,37684,7.4
Maine,1981,322849,20186,1021,0.316,27.34,2648,11.388,2620,11.268,23266,1932,1946,7929,15150,30005,45155,13.986,4.693,29753,44134,14381,13.67,4.454,835333,61.4,56.9,512600,475441,37159,7.2
Maine,1982,323572,19860,438,0.135,31.043,2504,10.821,2755,11.906,23014,1948,1966,10290,17556,33106,50662,15.657,5.426,30868,50224,19356,15.522,5.982,843167,61.8,56.5,521424,476722,44702,8.6
Maine,1983,325536,20143,4441,1.364,28.632,2873,12.422,2507,10.84,23311,1679,1699,8274,16464,34581,51045,15.68,5.058,30575,46604,16029,14.316,4.924,853500,62.7,57.5,534910,490541,44369,8.3
Maine,1984,337102,21551,20387,6.048,21.29,3559,14.787,2073,8.613,24811,1464,1488,6634,17991,38280,56271,16.693,5.337,22566,35884,13318,10.645,3.951,865250,63.4,59.5,548322,514827,33495,6.1
Maine,1985,349814,22331,5152,1.473,31.147,3496,13.875,2728,10.827,25580,1884,1919,10963,22212,37418,59630,17.046,6.35,31299,54478,23179,15.573,6.626,874583,63.5,59.9,555178,524201,30977,5.6
Maine,1986,358783,23448,16777,4.676,26.623,4087,15.586,2771,10.567,26881,1953,1999,10987,23229,41308,64537,17.988,6.474,30239,47760,17521,13.312,4.883,883417,64.1,60.7,565923,535955,29968,5.3
Maine,1987,378890,24766,24490,6.464,26.958,4554,16.465,2981,10.778,28445,2155,2182,15201,31515,44045,75560,19.942,8.318,28102,51070,22968,13.479,6.062,897917,65.2,62.4,585565,559979,25586,4.4
Maine,1988,404878,25975,23165,5.721,26.449,4560,15.621,3134,10.736,29905,2274,2289,11057,24780,51929,76709,18.946,6.12,35066,53544,18478,13.225,4.564,914750,65.4,63,598183,576282,21901,3.7
Maine,1989,425628,26840,19358,4.548,28.015,4444,14.6,3413,11.213,30953,2558,2616,14412,29274,49703,78977,18.555,6.878,36272,59619,23347,14.007,5.485,927500,66.1,63.4,612636,588218,24418,4
Maine,1990,428467,26365,-12925,-3.017,28.228,3487,11.334,3874,12.592,30573,2953,2997,16751,24356,36117,60473,14.114,5.684,50003,73398,23395,17.13,5.46,939446,67.3,63.7,631993,598351,33642,5.3
Maine,1991,411054,25566,-21993,-5.35,24.931,3351,11.053,3829,12.63,30078,2728,2758,14990,20663,30577,51240,12.466,5.027,49271,73233,23962,17.816,5.829,943988,67.9,62.6,640500,590703,49797,7.8
Maine,1992,396209,25306,-4998,-1.261,28.026,3187,10.641,3358,11.211,29866,2222,2263,10942,20104,35416,55520,14.013,5.074,38490,60518,22028,15.274,5.56,945377,67.9,62.8,641459,594159,47300,7.4
Maine,1993,401271,25679,14616,3.642,24.764,3327,11.099,3112,10.381,30084,2011,2066,9379,22205,42097,64302,16.025,5.534,32288,49686,17398,12.382,4.336,948932,66.4,61.9,630159,587297,42862,6.8
Maine,1994,413560,26092,7853,1.899,25.536,3520,11.587,2967,9.767,30655,2110,2150,12005,20507,40150,60657,14.667,4.959,34477,52804,18327,12.768,4.432,951821,65.9,61.5,627061,585808,41253,6.6
Maine,1995,424472,26727,14285,3.365,22.308,3630,11.715,2965,9.569,31318,2056,2099,9984,20106,41525,61631,14.519,4.737,31568,47346,15778,11.154,3.717,955709,66.9,62.9,639131,601495,37636,5.9
Maine,1996,430685,27126,3981,0.924,25.399,3710,11.775,3089,9.804,31819,2163,2185,11071,21567,37108,58675,13.624,5.008,36047,54694,18647,12.699,4.33,962848,68,64.4,654553,619707,34846,5.3
Maine,1997,437274,27567,10507,2.403,25.576,3784,11.784,3205,9.981,32402,2151,2197,12599,22204,44222,66426,15.191,5.078,34586,55919,21333,12.788,4.879,970403,67.8,64.3,658175,623926,34249,5.2
Maine,1998,454303,28247,13772,3.031,23.518,3772,11.477,3051,9.283,33226,2061,2089,10131,22734,44460,67194,14.791,5.004,36377,53422,17045,11.759,3.752,975875,67.2,64.2,655518,626124,29394,4.5
Maine,1999,466752,28819,10032,2.149,24.634,3655,10.891,3045,9.074,33864,2038,2083,11192,21671,45852,67523,14.467,4.643,38593,57491,18898,12.317,4.049,984264,68,65.2,668939,642081,26858,4
Maine,2000,482371,29189,18484,3.832,22.613,3572,10.454,3060,8.956,34424,2099,2145,11477,23266,49757,73023,15.138,4.823,34406,54539,20133,11.306,4.174,994236,68.1,65.9,677489,654981,22508,3.3
Maine,2001,493327,29292,3047,0.618,26.602,3605,10.432,3282,9.497,34719,2218,2250,11420,26180,42484,68664,13.919,5.307,41978,65617,23639,13.301,4.792,1004670,67.2,64.7,674958,649627,25331,3.8
Maine,2002,494144,29169,-13710,-2.774,28.245,3872,11.094,3787,10.851,34944,2324,2357,14941,28415,41370,69785,14.122,5.75,56189,83495,27306,16.897,5.526,1015879,66.8,63.8,678559,648301,30258,4.5
Maine,2003,487724,29518,2058,0.422,27.079,3684,10.484,3243,9.229,35360,2065,2113,11467,24174,43919,68093,13.961,4.956,43812,66035,22223,13.539,4.556,1026711,66.7,63.3,685165,649899,35266,5.1
Maine,2004,491736,29973,6379,1.297,22.266,3689,10.356,3169,8.896,35881,2164,2200,11684,19369,41755,61124,12.43,3.939,35833,54745,18912,11.133,3.846,1035627,66.2,63.2,685989,654082,31907,4.7
Maine,2005,496323,30284,2699,0.544,23.938,3703,10.252,3236,8.959,36354,2133,2151,9941,21411,40692,62103,12.513,4.314,41631,59404,17773,11.969,3.581,1043211,66.6,63.4,695280,661176,34104,4.9
Maine,2006,502239,30655,7722,1.538,23.289,4273,11.639,3549,9.667,37075,2532,2557,11264,25932,40274,66206,13.182,5.163,39334,58484,19150,11.645,3.813,1050791,66.7,63.6,700747,667801,32946,4.7
Maine,2007,503547,30716,-5016,-0.996,26.519,3971,10.671,3663,9.843,37367,2446,2462,13794,23439,43329,66768,13.26,4.655,45246,71784,26538,14.256,5.27,1056884,66.2,63.1,699753,667061,32692,4.7
Maine,2008,503960,30105,4614,0.916,24.375,3446,9.295,3999,10.786,36799,2625,2673,12290,20856,45179,66035,13.103,4.138,40387,61421,21034,12.188,4.174,1062381,66.1,62.5,701930,664441,37489,5.3
Maine,2009,497424,28983,-19220,-3.864,20.625,2919,8.038,4100,11.29,35726,2595,2618,12410,17979,33317,51296,10.312,3.614,50946,70516,19570,14.176,3.934,1064932,65.5,60,697698,639142,58556,8.4
Maine,2010,484175,28777,-8757,-1.809,20.927,3197,8.966,3365,9.437,35573,2042,2077,8909,18160,32501,50661,10.463,3.751,42224,59418,17194,12.272,3.551,1073083,65,59.5,697832,638984,58848,8.4
Maine,2011,479365,28362,-842,-0.176,22.322,3141,8.873,3498,9.882,35220,2090,2183,10479,17460,36043,53503,11.161,3.642,36293,54345,18052,11.337,3.766,1079356,64.8,59.8,698979,644967,54012,7.7
Maine,2012,481535,28263,5032,1.045,21.395,3189,9.066,3265,9.282,35139,1934,2009,9185,16871,39674,56545,11.743,3.504,34938,51513,16575,10.698,3.442,1082405,64.7,60.1,700730,650315,50415,7.2
Maine,2013,485137,28139,-510,-0.105,22.509,3056,8.706,3100,8.831,35082,1793,1826,9716,16334,38265,54599,11.254,3.367,35836,55109,19273,11.359,3.973,1085150,64.9,60.5,704240,657058,47182,6.7
Maine,2014,488113,28239,6152,1.26,20.484,3178,9.027,2941,8.354,35323,1740,1768,7293,21081,35064,56145,11.502,4.319,34735,49993,15258,10.242,3.126,1089257,64.1,60.5,698035,659008,39027,5.6
Maine,2015,495400,28430,8857,1.788,19.889,3206,9.037,2890,8.146,35635,1777,1808,7876,17823,40300,58123,11.733,3.598,32257,49266,17009,9.945,3.433,1091324,63,60.3,687859,657550,30309,4.4
Maine,2016,505410,29115,10267,2.031,18.525,3482,9.656,2638,7.315,36484,1709,1747,9074,19215,37866,57081,11.294,3.802,31156,46814,15658,9.263,3.098,1094744,63.4,61,693917,667723,26194,3.8
Maine,2017,511219,29165,3405,0.666,21.779,3078,8.434,3061,8.387,36504,1868,1909,9476,16280,42794,59074,11.556,3.185,37130,55669,18539,10.889,3.626,1106282,63.6,61.5,703871,680164,23707,3.4
Maine,2018,514259,29342,2721,0.529,20.816,2911,7.973,2867,7.852,36535,1794,1830,8680,14536,41709,56245,10.937,2.827,37291,53524,16233,10.408,3.157,1112504,63,61,700856,678584,22272,3.2
Maine,2019,518939,29540,6862,1.322,19.325,3174,8.647,2812,7.661,36888,1876,1898,8482,15467,41538,57005,10.985,2.981,34688,50143,15455,9.663,2.978,1119828,62.4,60.5,698261,678011,20250,2.9
Maine,2020,522050,29579,10,0.002,20.51,3156,8.543,3017,8.167,37013,1954,1986,9649,16511,37036,53547,10.257,3.163,38057,53537,15480,10.255,2.965,1127116,59.6,56.6,671979,637985,33994,5.1
Maine,2021,514029,29900,-15723,-3.059,23.084,3641,9.795,3285,8.837,37350,2076,2110,9674,24246,35084,59330,11.542,4.717,55785,75053,19268,14.601,3.748,1140733,60.4,57.5,688542,656138,32404,4.7
Maine,2022,518924,30452,26180,5.045,21.415,3988,10.594,3337,8.865,37970,2298,2344,10448,21009,60735,81744,15.753,4.049,35884,55564,19680,10.708,3.792,1152323,59.1,57.4,681172,661833,19339,2.8
Maryland,1978,1165274,60051,70344,6.037,27.002,9458,13.4,7381,10.458,71619,4861,4958,27665,69682,157988,227670,19.538,5.98,97433,157326,59893,13.501,5.14,3076917,66.6,62.9,2049194,1934304,114890,5.6
Maryland,1979,1238894,62146,67069,5.414,25.22,9477,12.977,7077,9.691,74228,4872,4937,25781,67405,155888,223293,18.024,5.441,101792,156224,54432,12.61,4.394,3114500,67.7,63.8,2108571,1987170,121401,5.8
Maryland,1980,1288525,63036,29170,2.264,28.887,8930,11.941,7828,10.467,75338,5394,5468,28767,68058,147219,215277,16.707,5.282,132988,186107,53119,14.443,4.122,3145417,68.1,63.6,2143042,2001458,141584,6.6
Maryland,1981,1310877,63545,12402,0.946,29.276,9093,11.983,7900,10.411,76480,5507,5606,31146,75503,128784,204287,15.584,5.76,136297,191885,55588,14.638,4.241,3194583,67.8,63,2167411,2013686,153725,7.1
Maryland,1982,1316429,63462,-2743,-0.208,31.997,9103,11.873,8741,11.401,76849,5945,6055,34494,77441,133170,210611,15.999,5.883,149401,213354,63953,16.207,4.858,3226500,67.6,62,2181679,2001581,180098,8.3
Maryland,1983,1331681,65985,26291,1.974,30.063,10346,13.222,7647,9.773,79595,5141,5227,29647,74535,151929,226464,17.006,5.597,135016,200173,65157,15.032,4.893,3248000,68,63.3,2208015,2054616,153399,6.9
Maryland,1984,1396676,68762,108351,7.758,24.04,11331,13.941,8114,9.983,82887,5674,5762,32002,95017,181215,276232,19.778,6.803,109092,167881,58789,12.02,4.209,3288167,68.3,64.7,2247452,2127803,119649,5.3
Maryland,1985,1482239,71058,101545,6.851,27.981,12507,14.859,9908,11.772,85468,7071,7222,51111,109514,199400,308914,20.841,7.388,120293,207369,87076,13.99,5.875,3339583,68.2,65.1,2278294,2172809,105485,4.6
Maryland,1986,1570180,74641,77280,4.922,29.889,13161,15.011,8677,9.897,89915,5981,6083,41696,115110,196826,311936,19.866,7.331,162553,234656,72103,14.945,4.592,3391917,69.3,66.2,2350842,2244036,106806,4.5
Maryland,1987,1656993,77219,80816,4.877,31.393,13654,14.874,9860,10.741,93695,6767,6872,49941,133559,207348,340907,20.574,8.06,165740,260091,94351,15.697,5.694,3450000,69.8,66.8,2406952,2303571,103381,4.3
Maryland,1988,1724832,80028,57788,3.35,32.175,14190,14.81,10212,10.658,97805,7021,7162,50437,135292,199981,335273,19.438,7.844,188945,277485,88540,16.088,5.133,3511167,70,67.1,2458361,2355321,103040,4.2
Maryland,1989,1776845,82514,46357,2.609,30.987,13778,13.849,10467,10.521,101145,7183,7313,53381,122231,199424,321655,18.103,6.879,176992,275298,98306,15.494,5.533,3556833,70.5,67.8,2507844,2413103,94741,3.8
Maryland,1990,1821840,84627,42136,2.313,29.733,13283,12.952,10477,10.216,103955,7376,7527,53531,108572,204412,312984,17.18,5.959,179949,270848,90899,14.867,4.989,3690697,69.8,66.7,2574511,2463298,111213,4.3
Maryland,1991,1791181,83634,-106199,-5.929,27.751,12657,12.169,12367,11.89,104158,8502,8645,65352,105582,142956,248538,13.876,5.895,235807,354737,118930,19.805,6.64,3719173,70.3,66.2,2616219,2460853,155366,5.9
Maryland,1992,1730320,83776,-30700,-1.774,31.007,11926,11.439,11590,11.117,104424,7308,7496,49817,95959,172305,268264,15.504,5.546,199932,298964,99032,17.278,5.723,3743319,70.9,66.3,2655427,2481615,173812,6.5
Maryland,1993,1716867,85494,5914,0.344,30.825,12134,11.572,11233,10.712,105310,6870,7082,43628,92190,178340,270530,15.757,5.37,178951,264616,85665,15.413,4.99,3766632,70.7,66.4,2661634,2502493,159141,6
Maryland,1994,1736375,86880,20663,1.19,29.522,12164,11.456,10678,10.056,106924,7110,7311,44670,93594,183376,276970,15.951,5.39,170224,256307,86083,14.761,4.958,3794945,70.9,67.2,2689237,2549050,140187,5.2
Maryland,1995,1775265,89021,65132,3.669,25.484,13068,12.079,10503,9.708,109471,7150,7360,43866,99025,192315,291340,16.411,5.578,143834,226208,82374,12.742,4.64,3822757,71,67.4,2712757,2577825,134932,5
Maryland,1996,1797329,89395,11244,0.626,29.626,12257,11.187,11073,10.106,110156,7468,7643,47980,106103,171383,277486,15.439,5.903,178962,266242,87280,14.813,4.856,3859320,71.2,67.7,2749092,2613028,136064,4.9
Maryland,1997,1840935,90140,57134,3.104,31.39,13458,12.158,12499,11.291,111175,8012,8258,50877,126898,219171,346069,18.799,6.893,178792,288935,110143,15.695,5.983,3889216,71.2,67.8,2771027,2637899,133128,4.8
Maryland,1998,1921759,91115,59108,3.076,27.736,12484,11.14,11506,10.268,112551,7285,7544,47319,118326,207290,325616,16.944,6.157,172338,266508,94170,13.868,4.9,3919446,70.5,67.5,2763123,2645646,117477,4.3
Maryland,1999,1961592,91691,26220,1.337,30.337,12157,10.774,11550,10.236,113136,7135,7281,51984,111750,212016,323766,16.505,5.697,186172,297546,111374,15.169,5.678,3954592,70,67.6,2770084,2674306,95778,3.5
Maryland,2000,2031219,91974,75998,3.741,27.034,11982,10.547,11232,9.887,113979,7091,7257,42379,112386,238174,350560,17.259,5.533,175109,274562,99453,13.517,4.896,3994408,70.1,67.7,2801391,2702430,98961,3.5
Maryland,2001,2071742,92727,13089,0.632,29.982,12727,11.121,11709,10.231,114955,6921,7306,50855,118843,204822,323665,15.623,5.736,196100,310576,114476,14.991,5.526,4049596,70,67.1,2836279,2717443,118836,4.2
Maryland,2002,2078891,93724,-28421,-1.367,32.412,14124,12.164,12463,10.733,116944,7061,7289,61291,137779,199127,336906,16.206,6.628,239735,365327,125592,17.573,6.041,4106699,69.9,66.6,2872367,2734977,137390,4.8
Maryland,2003,2071525,95349,14064,0.679,28.666,12996,11.041,11432,9.712,118494,6882,7058,40193,102197,208777,310974,15.012,4.933,204268,296910,92642,14.333,4.472,4156957,69.3,66,2881024,2742966,138058,4.8
Maryland,2004,2114798,97522,66163,3.129,24.864,13454,11.24,11079,9.256,120887,6955,7072,42366,106895,222180,329075,15.561,5.055,168698,262912,94214,12.432,4.455,4206817,68.6,65.4,2885111,2752186,132925,4.6
Maryland,2005,2158628,99398,14110,0.654,27.041,13978,11.453,11734,9.615,123164,7337,7455,48406,110287,195676,305963,14.174,5.109,195364,291853,96489,13.52,4.47,4253903,68.9,65.8,2931581,2799960,131621,4.5
Maryland,2006,2200370,101511,65955,2.997,25.537,15265,12.23,11978,9.597,126458,7903,8037,45077,126401,220509,346910,15.766,5.745,183935,280955,97020,12.769,4.409,4294115,69.5,66.6,2984444,2860048,124396,4.2
Maryland,2007,2231456,101778,-6886,-0.309,29.273,14123,11.132,13255,10.448,127298,8348,8468,48024,107931,218675,326606,14.636,4.837,228880,333492,104612,14.945,4.688,4325591,69.1,66.5,2989317,2877994,111323,3.7
Maryland,2008,2223028,100036,-3296,-0.148,27.617,12227,9.668,13776,10.893,125693,8814,8966,45094,94660,212308,306968,13.809,4.258,205192,310264,105072,13.957,4.727,4357178,69.5,66.4,3027934,2891508,136426,4.5
Maryland,2009,2174872,97007,-105383,-4.845,23.273,11193,8.982,14279,11.458,123076,8840,8980,48972,95635,157445,253080,11.637,4.397,240389,358463,118074,16.482,5.429,4397392,69.4,64.1,3049869,2819397,230472,7.6
Maryland,2010,2096416,95673,-49199,-2.347,23.343,11309,9.243,12834,10.489,121595,7630,7921,43894,82202,162479,244681,11.671,3.921,208222,293880,85658,14.018,4.086,4488288,68.6,63.2,3078368,2836945,241423,7.8
Maryland,2011,2091207,94857,33115,1.584,22.923,11524,9.488,11814,9.727,121309,7411,7527,37965,86726,186077,272803,13.045,4.147,165506,239688,74182,11.462,3.547,4553235,68,63.1,3097300,2870857,226443,7.3
Maryland,2012,2127095,95697,34678,1.63,23.48,11505,9.455,10737,8.823,122071,6227,6383,34474,82525,201869,284394,13.37,3.88,170162,249716,79554,11.74,3.74,4601141,67.8,63.2,3120947,2906518,214429,6.9
Maryland,2013,2161959,95836,34687,1.604,23.202,11596,9.474,10886,8.894,122750,6454,6608,44979,96176,189316,285492,13.205,4.449,167482,250805,83323,11.601,3.854,4639292,67.4,63,3128908,2924626,204282,6.5
Maryland,2014,2193053,95989,26064,1.188,21.426,11764,9.545,10806,8.767,123730,6562,6633,33401,79933,181069,261002,11.901,3.645,166561,234938,68377,10.713,3.118,4670634,66.9,63.1,3125017,2945911,179106,5.7
Maryland,2015,2219548,96158,27180,1.225,21.84,11357,9.161,10870,8.768,124215,6619,6736,36676,91170,178384,269554,12.145,4.108,165476,242374,76898,10.92,3.465,4697561,66.8,63.5,3139988,2983083,156905,5
Maryland,2016,2257200,97189,45467,2.014,19.97,11842,9.46,9892,7.902,126160,6302,6430,36384,84398,186447,270845,11.999,3.739,155024,225378,70354,9.985,3.117,4715122,66.9,64.1,3155918,3020827,135091,4.3
Maryland,2017,2303672,97288,49554,2.151,23.153,11205,8.879,11150,8.835,126226,6643,6769,39094,90103,226139,316242,13.728,3.911,177209,266688,89479,11.577,3.884,4799005,67.6,64.9,3243896,3114580,129316,4
Maryland,2018,2343789,97593,31419,1.341,21.74,10980,8.696,10835,8.581,126338,6581,6712,39468,84241,201948,286189,12.211,3.594,176597,254770,78173,10.87,3.335,4823675,67.8,65.2,3270635,3146485,124150,3.8
Maryland,2019,2370646,98067,21570,0.91,20.246,10947,8.64,10219,8.065,127069,6703,6833,39331,80026,181519,261545,11.033,3.376,164905,239975,75070,10.123,3.167,4846181,68.9,66.6,3338480,3225825,112655,3.4
Maryland,2020,2395771,97640,31405,1.311,21.143,11156,8.784,11292,8.891,126931,6988,7124,40960,86187,198481,284668,11.882,3.597,174176,253263,79087,10.571,3.301,4857232,66.5,62.2,3230561,3022470,208091,6.4
Maryland,2021,2343574,98187,-121045,-5.165,21.88,12668,9.985,12784,10.076,126815,7318,7588,43516,78440,177943,256383,10.94,3.347,283979,377428,93449,16.105,3.987,4865542,64.8,61.4,3152885,2988216,164669,5.2
Maryland,2022,2337952,99972,111337,4.762,22.406,13767,10.793,12229,9.587,128328,8008,8160,44964,117226,256030,373256,15.965,5.014,162091,261919,99828,11.203,4.27,4869932,64.8,62.8,3154854,3060216,94638,3
Massachusetts,1978,1996634,95961,151126,7.569,23.469,13022,11.836,10539,9.579,111261,6980,7103,39722,109640,275778,385418,19.303,5.491,139354,234292,94938,11.734,4.755,4297167,65.5,61.4,2813196,2639856,173340,6.2
Massachusetts,1979,2148343,98298,137215,6.387,22.18,12648,11.216,10170,9.018,114011,6856,6943,38926,105585,269878,375463,17.477,4.915,161974,238248,76274,11.09,3.55,4338667,65.8,62.2,2856579,2700012,156567,5.5
Massachusetts,1980,2245037,99436,54493,2.427,25.431,12062,10.51,10689,9.314,115452,7377,7477,39994,96591,243369,339960,15.143,4.302,199149,285467,86318,12.715,3.845,4374417,65.6,61.9,2871168,2705849,165319,5.8
Massachusetts,1981,2305139,100378,40742,1.767,27.804,12391,10.659,10632,9.146,117131,7326,7462,55085,124436,236765,361201,15.669,5.398,212191,320459,108268,13.902,4.697,4417500,66.7,62.4,2945288,2756609,188679,6.4
Massachusetts,1982,2331382,100452,-14613,-0.627,27.223,12398,10.551,11750,10,117824,8206,8289,52771,105597,211743,317340,13.612,4.529,238891,331953,93062,14.238,3.992,4443000,67.1,61.8,2979497,2747260,232237,7.8
Massachusetts,1983,2342305,102807,29517,1.26,28.811,13713,11.51,11149,9.358,120422,7570,7689,50336,120672,246269,366941,15.666,5.152,238390,337424,99034,14.406,4.228,4472250,66.6,62,2979135,2772804,206331,6.9
Massachusetts,1984,2425230,107749,168549,6.95,21.869,15436,12.538,9996,8.119,125832,7021,7119,43865,136870,296860,433730,17.884,5.644,182454,265181,82727,10.934,3.411,4510667,67.5,64.2,3042527,2897170,145357,4.8
Massachusetts,1985,2564183,110925,110828,4.322,26.647,16053,12.58,12461,9.765,129400,8948,9164,72162,126644,325823,452467,17.646,4.939,215278,341639,126361,13.324,4.928,4533833,67.3,64.6,3053401,2927250,126151,4.1
Massachusetts,1986,2651260,114560,67277,2.538,28.797,17585,13.357,12931,9.822,133983,9129,9304,67277,153112,295903,449015,16.936,5.775,266801,381738,114937,14.398,4.335,4562833,67.2,64.5,3067544,2945306,122238,4
Massachusetts,1987,2737400,118166,57504,2.101,31.24,19110,14.017,14447,10.597,138667,10139,10280,75814,183208,301872,485080,17.72,6.693,291298,427576,136278,15.62,4.978,4587417,67.6,65.4,3102943,2998485,104458,3.4
Massachusetts,1988,2799349,121891,54517,1.947,30.268,19156,13.573,14678,10.4,143368,10114,10300,71563,169253,308921,478174,17.082,6.046,282729,423657,140928,15.134,5.034,4611500,68.4,66.1,3153105,3049072,104033,3.3
Massachusetts,1989,2852674,123442,50303,1.763,30.529,17992,12.433,15412,10.651,145996,11316,11489,78936,171822,313922,485744,17.028,6.023,293396,435441,142045,15.264,4.979,4617917,69,66.1,3186592,3052030,134562,4.2
Massachusetts,1990,2838291,120532,-109566,-3.86,25.923,15092,10.418,17410,12.018,143710,12893,13121,82921,130687,237194,367881,12.961,4.604,335625,477447,141822,16.822,4.997,4713235,68.6,64.2,3233071,3027246,205825,6.4
Massachusetts,1991,2686009,115059,-201785,-7.512,23.861,14412,10.185,18546,13.107,139429,12715,13120,108558,122859,197591,320450,11.93,4.574,344983,522235,177252,19.443,6.599,4695650,67.8,61.8,3184304,2902502,281802,8.8
Massachusetts,1992,2561942,112881,-23661,-0.924,28.664,13604,9.842,15764,11.405,137141,10058,10311,67991,128261,238917,367178,14.332,5.006,261346,390839,129493,15.256,5.054,4685947,68,62,3184569,2904566,280003,8.8
Massachusetts,1993,2566525,114023,37774,1.472,27.85,14076,10.236,13284,9.66,137906,8645,8999,55331,121280,273877,395157,15.397,4.725,240735,357383,116648,13.925,4.545,4693661,67.9,63,3187638,2955441,232197,7.3
Massachusetts,1994,2614551,115871,31693,1.212,27.345,14938,10.731,12685,9.113,140325,8554,8734,58486,123795,265373,389168,14.885,4.735,243308,357475,114167,13.673,4.367,4713875,67.8,63.6,3196893,2997235,199658,6.2
Massachusetts,1995,2662962,118342,74370,2.793,24.86,16011,11.283,12799,9.02,143506,8558,8999,62556,133821,271550,405371,15.223,5.025,218556,331001,112445,12.43,4.223,4747090,67.5,63.8,3203588,3028707,174881,5.5
Massachusetts,1996,2688634,119115,40108,1.492,25.645,15123,10.52,13232,9.204,144702,8764,9070,66490,124263,260599,384862,14.314,4.622,218967,344754,125787,12.823,4.678,4781387,67.7,64.6,3236058,3086616,149442,4.6
Massachusetts,1997,2744786,121268,58966,2.148,28.537,16192,11.09,13713,9.392,147250,8817,9049,67286,159489,291111,450600,16.417,5.811,249526,391634,142108,14.268,5.177,4819768,68.6,65.8,3305601,3171544,134057,4.1
Massachusetts,1998,2839102,123220,73999,2.606,25.997,14882,10.004,13034,8.762,149685,8259,8442,52914,136331,306711,443042,15.605,4.802,258496,369043,110547,12.999,3.894,4854899,68.6,66.3,3331560,3218908,112652,3.4
Massachusetts,1999,2905530,125515,51147,1.76,27.164,15948,10.566,13531,8.964,152150,8544,8814,61074,143070,302710,445780,15.342,4.924,265795,394633,128838,13.582,4.434,4894363,68.6,66.4,3358739,3247960,110779,3.3
Massachusetts,2000,2993830,126953,106380,3.553,25.834,15636,10.201,13470,8.788,154367,8559,8928,63441,152704,340384,493088,16.47,5.101,249018,386708,137690,12.917,4.599,4928941,67.8,65.9,3340566,3246356,94210,2.8
Massachusetts,2001,3059825,127160,33782,1.104,29.137,15354,9.931,14585,9.433,154994,9078,9329,71876,155018,324542,479560,15.673,5.066,282638,445778,163140,14.569,5.332,4972559,68.1,65.5,3386892,3258352,128540,3.8
Massachusetts,2002,3040113,126473,-114435,-3.764,29.963,16625,10.686,16442,10.569,155663,9890,10112,87121,175066,280383,455449,14.981,5.759,382927,569884,186957,18.745,6.15,5006050,68.7,65.1,3436864,3257517,179347,5.2
Massachusetts,2003,2976729,128693,-24339,-0.818,28.346,17063,10.892,14997,9.573,157693,8938,9104,58718,134373,287526,421899,14.173,4.514,284908,446238,161330,14.991,5.42,5028614,68,64.1,3418989,3223294,195695,5.7
Massachusetts,2004,2970867,127532,3604,0.121,25.706,15685,9.975,16651,10.589,156760,11719,11878,61480,131399,254050,385449,12.974,4.423,258320,381845,123525,12.853,4.158,5043901,67.4,64,3400830,3226991,173839,5.1
Massachusetts,2005,2982586,126791,14876,0.499,24.389,15432,9.85,15653,9.991,156563,10435,10596,56807,126965,251627,378592,12.693,4.257,236649,363716,127067,12.195,4.26,5063714,66.9,63.6,3385536,3222953,162583,4.8
Massachusetts,2006,3026413,128416,66374,2.193,24.513,17151,10.859,14345,9.082,159349,9540,9698,58509,150363,286939,437302,14.45,4.968,250349,370928,120579,12.256,3.984,5092894,67,63.8,3411688,3251029,160659,4.7
Massachusetts,2007,3057772,127751,9747,0.319,26.352,15614,9.803,15664,9.834,159253,9831,9998,54536,128389,284248,412637,13.495,4.199,278194,402890,124696,13.176,4.078,5134517,66.9,63.8,3433239,3277912,155327,4.5
Massachusetts,2008,3062553,125713,5811,0.19,25.599,13913,8.783,15497,9.783,157615,9984,10137,56008,120354,277444,397798,12.989,3.93,269300,391987,122687,12.799,4.006,5184502,66.9,63.3,3465906,3282299,183607,5.3
Massachusetts,2009,3017936,122558,-107041,-3.547,21.221,12438,7.96,16084,10.294,154427,9833,10058,63925,109733,210491,320224,10.611,3.636,308847,427265,118418,14.158,3.924,5237356,66.3,60.9,3470431,3189506,280925,8.1
Massachusetts,2010,2948073,121056,-34773,-1.18,22.001,13380,8.695,14570,9.469,153283,8721,8931,47690,104793,219505,324298,11,3.555,259700,359071,99371,12.18,3.371,5252272,66.2,60.9,3479304,3198617,280687,8.1
Massachusetts,2011,2949304,120884,36172,1.226,20.184,13447,8.766,13232,8.626,153502,7964,8095,41978,91224,242591,333815,11.318,3.093,213440,297643,84203,10.092,2.855,5295565,65.8,61,3484135,3232458,251677,7.2
Massachusetts,2012,2999944,122309,63072,2.102,19.726,14105,9.154,12903,8.374,154694,7470,7690,45840,92281,266671,358952,11.965,3.076,199244,295880,96636,9.863,3.221,5351700,65.5,61.1,3506457,3271256,235201,6.7
Massachusetts,2013,3055827,122744,47280,1.547,19.695,13731,8.858,12977,8.372,155383,7689,7838,41972,101171,247034,348205,11.395,3.311,204645,300925,96280,9.848,3.151,5407696,65,60.7,3516689,3283144,233545,6.6
Massachusetts,2014,3077002,123456,20859,0.678,20.7,13555,8.691,12408,7.956,156540,7708,7922,42591,107936,231391,339327,11.028,3.508,233806,318468,84662,10.35,2.751,5461991,65.4,61.6,3569557,3364853,204704,5.7
Massachusetts,2015,3129498,124009,82792,2.646,18.518,13831,8.806,12825,8.166,157558,7816,7966,46281,113992,258560,372552,11.905,3.643,197494,289760,92266,9.259,2.948,5504919,65.2,62.1,3589409,3417296,172113,4.8
Massachusetts,2016,3199432,126144,62071,1.94,19.121,15112,9.49,11746,7.376,160926,7781,7921,46075,105869,262081,367950,11.5,3.309,221676,305879,84203,9.56,2.632,5543887,65.3,62.6,3617498,3472327,145171,4
Massachusetts,2017,3263194,126809,64022,1.962,20.942,14261,8.834,13277,8.225,161922,8099,8308,55048,118102,287614,405716,12.433,3.619,228749,341694,112945,10.471,3.461,5654177,65.9,63.4,3724520,3582389,142131,3.8
Massachusetts,2018,3311332,127281,53613,1.619,21.123,13627,8.411,13355,8.244,162141,8258,8403,49148,123761,279584,403345,12.181,3.737,239233,349732,110499,10.562,3.337,5694039,67.1,64.7,3818769,3686198,132571,3.5
Massachusetts,2019,3351356,128365,70657,2.108,17.929,14240,8.736,12505,7.671,163880,8399,8537,47013,103220,267875,371095,11.073,3.08,205562,300438,94876,8.965,2.831,5725399,67.2,65.2,3848611,3731900,116711,3
Massachusetts,2020,3390728,128219,10972,0.324,20.69,14129,8.619,14059,8.577,163955,9005,9189,55649,112653,249090,361743,10.669,3.322,243655,350771,107116,10.345,3.159,5729754,65.3,59.3,3744255,3396014,348241,9.3
Massachusetts,2021,3288933,126158,-216179,-6.573,19.342,14613,8.994,17572,10.816,160987,9982,10276,56618,96871,221202,318073,9.671,2.945,407454,534252,126798,16.244,3.855,5733756,65.1,61.6,3731417,3530207,201210,5.4
Massachusetts,2022,3290020,129988,210445,6.396,20.098,17758,10.903,13952,8.566,164773,9382,9629,53808,133982,407069,541051,16.445,4.072,211900,330606,118706,10.049,3.608,5741238,65.2,62.8,3743592,3606318,137274,3.7
Michigan,1978,2845555,127316,229258,8.057,22.217,20425,13.637,15521,10.362,152233,10384,10569,60687,160123,385233,545356,19.165,5.627,179059,316098,137039,11.108,4.816,6634500,63.6,59.1,4220095,3923236,296859,7
Michigan,1979,3033325,131055,167179,5.511,22.068,18752,12.127,14752,9.54,156636,10315,10477,56330,137332,364548,501880,16.546,4.527,233764,334701,100937,11.034,3.328,6718333,64.3,59.3,4322170,3982939,339231,7.8
Michigan,1980,3010623,130940,-211020,-7.009,23.473,17553,11.175,16854,10.73,157422,11926,12069,67163,124484,228864,353348,11.737,4.135,442745,564368,121623,18.746,4.04,6769333,64,56.1,4329519,3798240,531279,12.3
Michigan,1981,2868798,129739,-79837,-2.783,26.494,16999,10.826,17612,11.217,156708,12113,12347,64063,136835,243194,380029,13.247,4.77,330083,459866,129783,16.03,4.524,6781333,63.4,55.5,4297544,3765283,532261,12.4
Michigan,1982,2737552,126929,-98682,-3.605,27.217,16512,10.616,18872,12.133,154365,12841,13058,66560,115820,256720,372540,13.609,4.231,332439,471222,138783,17.213,5.07,6754167,63.3,53.5,4274498,3611639,662859,15.5
Michigan,1983,2689347,130082,-19147,-0.712,30.325,19434,12.453,16256,10.417,157649,10805,11031,66741,140502,267272,407774,15.163,5.224,294970,426921,131951,15.875,4.906,6718250,63.5,54.3,4267681,3650527,617154,14.5
Michigan,1984,2721441,135352,228344,8.391,21.346,20926,13.042,15353,9.569,163239,10785,10967,55805,156618,362181,518799,19.063,5.755,174219,290455,116236,10.673,4.271,6742500,63.9,56.8,4311766,3826961,484805,11.2
Michigan,1985,2899233,138073,123781,4.269,27.832,20663,12.538,17497,10.617,166389,12597,12873,83969,186139,341101,527240,18.186,6.42,232838,403459,170621,13.916,5.885,6793833,64.2,57.7,4359727,3923168,436559,10
Michigan,1986,3034415,140952,159698,5.263,24.829,21672,12.858,17207,10.209,170787,12326,12517,74081,180102,356299,536401,17.677,5.935,248731,376703,127972,12.414,4.217,6857417,64.2,58.5,4401700,4009884,391816,8.9
Michigan,1987,3145357,143512,44999,1.431,30.963,22561,13.056,18550,10.735,174803,12775,12958,82972,193896,338053,531949,16.912,6.165,322379,486950,164571,15.482,5.232,6931333,65,59.6,4506324,4129103,377221,8.4
Michigan,1988,3187110,147046,21223,0.666,30.98,22615,12.756,18256,10.297,179469,12246,12546,85603,195032,319875,514907,16.156,6.119,326570,493684,167114,15.49,5.243,6967833,65.3,60.3,4548841,4204332,344509,7.6
Michigan,1989,3269343,150998,132329,4.048,25.314,22889,12.562,17528,9.62,184883,12340,12722,76698,176562,369560,546122,16.704,5.401,271601,413793,142192,12.657,4.349,6984833,66,61.3,4608840,4278222,330618,7.2
Michigan,1990,3365428,153837,49023,1.457,27.692,21869,11.699,17865,9.557,188939,12892,13255,77957,192750,322248,514998,15.303,5.727,329259,465975,136716,13.846,4.062,7014564,65.8,60.7,4614499,4260960,353539,7.7
Michigan,1991,3327774,153746,-157207,-4.724,25.99,21279,11.218,19364,10.209,190640,13660,14034,106781,165364,267079,432443,12.995,4.969,400169,589650,189481,17.719,5.694,7073529,65,59,4596908,4170223,426685,9.3
Michigan,1992,3261398,153456,33471,1.026,27.97,19702,10.339,19390,10.175,190715,12675,12986,75721,148996,340580,489576,15.011,4.568,313892,456105,142213,13.985,4.36,7128843,65.5,59.6,4671377,4247132,424245,9.1
Michigan,1993,3329150,156477,89930,2.701,26.203,20036,10.432,17302,9.009,193423,11616,11974,66493,162173,363923,526096,15.803,4.871,295072,436166,141094,13.101,4.238,7175073,65.8,61,4723170,4376113,347057,7.3
Michigan,1994,3446617,159536,110791,3.214,24.571,20967,10.722,17289,8.841,197397,12099,12504,74944,177578,356654,534232,15.5,5.152,278781,423441,144660,12.286,4.197,7225054,66.5,62.4,4802150,4509453,292697,6.1
Michigan,1995,3578946,163545,159211,4.449,23.755,22387,11.201,17412,8.712,202349,12090,12395,77342,198756,385545,584301,16.326,5.553,284379,425090,140711,11.878,3.932,7287368,66.3,62.8,4830790,4573514,257276,5.3
Michigan,1996,3640026,165367,37444,1.029,26.496,21909,10.771,17898,8.799,205413,12730,13072,84363,178159,341510,519669,14.277,4.894,342407,482225,139818,13.248,3.841,7359848,66.5,63.2,4893169,4653262,239907,4.9
Michigan,1997,3716626,166899,95538,2.571,28.73,22277,10.809,20996,10.187,206740,13701,14204,92575,200515,428914,629429,16.935,5.395,344725,533891,189166,14.365,5.09,7402329,67,64.2,4961910,4749340,212570,4.3
Michigan,1998,3849076,168452,87244,2.267,25.99,21130,10.137,19366,9.291,209323,12845,13335,82001,192152,395281,587433,15.262,4.992,345339,500189,154850,12.995,4.023,7433309,67.5,64.8,5019951,4820431,199520,4
Michigan,1999,3927850,168425,61494,1.566,27.028,20362,9.707,19506,9.299,210189,12886,13239,84533,203597,388699,592296,15.079,5.183,361101,530802,169701,13.514,4.32,7471040,68.3,65.7,5102445,4910684,191761,3.8
Michigan,2000,4006798,168502,61370,1.532,27.656,20205,9.597,19670,9.343,210800,12592,12959,88336,200633,414793,615426,15.36,5.007,358240,554056,195816,13.828,4.887,7516639,68.6,66.1,5156695,4968878,187817,3.6
Michigan,2001,4004288,167372,-79277,-1.98,28.243,20489,9.733,20864,9.911,210323,12945,13397,90965,193404,372069,565473,14.122,4.83,431281,644750,213469,16.101,5.331,7573057,67.9,64.3,5138844,4872118,266726,5.2
Michigan,2002,3923242,165745,-113576,-2.895,31.974,22818,10.847,23921,11.372,209805,14069,14452,113742,265384,361827,627211,15.987,6.764,492213,740787,248574,18.882,6.336,7621515,66.1,62,5034722,4723286,311436,6.2
Michigan,2003,3860106,165901,-16123,-0.418,29.883,21332,10.161,20976,9.991,210119,13039,13437,91309,195722,381036,576758,14.942,5.07,408102,592881,184779,15.359,4.787,7667604,65.7,61,5036119,4678901,357218,7.1
Michigan,2004,3858223,166989,9506,0.246,27.76,21076,10.015,20511,9.747,210722,12672,13282,94227,194792,350244,545036,14.127,5.049,346271,535530,189259,13.88,4.905,7706420,65.6,61,5056148,4703962,352186,7
Michigan,2005,3818470,167150,-85583,-2.241,26.504,21130,10.016,20685,9.805,211189,13367,13639,90776,188241,317792,506033,13.252,4.93,423669,591616,167947,15.494,4.398,7736940,65.5,61.1,5069602,4725701,343901,6.8
Michigan,2006,3771726,167342,14914,0.395,27.114,22589,10.653,20901,9.857,212884,14398,14638,83450,181715,344532,526247,13.952,4.818,350380,511333,160953,13.557,4.267,7764448,65.1,60.6,5056734,4701385,355349,7
Michigan,2007,3724010,164697,-106271,-2.854,26.204,21071,9.949,23005,10.862,210821,14940,15297,98406,168945,318966,487911,13.102,4.537,405594,594182,188588,15.955,5.064,7775228,64.2,59.7,4994841,4640173,354668,7.1
Michigan,2008,3637162,160716,-56593,-1.556,27.122,18861,9.036,22854,10.949,206744,15086,15371,105080,171552,321678,493230,13.561,4.717,361224,549823,188599,15.117,5.185,7772411,63.2,58.1,4915781,4513249,402532,8.2
Michigan,2009,3494053,155159,-253436,-7.253,22.587,16447,8.072,23837,11.699,200051,14820,15083,95561,143269,251337,394606,11.294,4.1,470500,648042,177542,18.547,5.081,7771824,62.5,54.3,4860036,4221462,638574,13.1
Michigan,2010,3325201,151632,-90378,-2.718,23.662,16173,8.167,20295,10.249,195961,12633,12934,76831,121530,271879,393409,11.831,3.655,334324,483787,149463,14.549,4.495,7739421,61.4,53.9,4754799,4173946,580853,12.2
Michigan,2011,3325361,150839,100050,3.009,22.484,18004,9.186,17920,9.143,196036,11359,11654,64688,129552,344329,473881,14.251,3.896,252209,373831,121622,11.242,3.657,7755122,60.2,54.2,4668979,4201785,467194,10
Michigan,2012,3415539,151558,83801,2.454,22.668,17163,8.753,17000,8.67,196169,10230,10541,74786,119635,351283,470918,13.788,3.503,248490,387117,138627,11.334,4.059,7791752,60.1,54.7,4685462,4261963,423499,9
Michigan,2013,3476581,151338,67827,1.951,21.215,16495,8.418,16813,8.58,195792,10359,10480,61424,127148,309463,436611,12.559,3.657,253517,368784,115267,10.608,3.316,7826581,60.5,55.2,4736919,4323410,413509,8.7
Michigan,2014,3545381,151304,79434,2.24,20.337,16593,8.463,16060,8.191,196331,10243,10467,62741,122988,316957,439945,12.409,3.469,243250,360511,117261,10.168,3.307,7859938,60.6,56.2,4759720,4416017,343703,7.2
Michigan,2015,3656765,152061,123019,3.364,19.747,18091,9.165,15996,8.104,198436,10233,10502,61216,149368,334706,484074,13.238,4.085,252904,361055,108151,9.874,2.958,7884087,60.4,57.1,4760207,4501816,258391,5.4
Michigan,2016,3764749,153502,90351,2.4,19.761,17716,8.87,15088,7.554,201048,10018,10301,70588,139631,322701,462332,12.281,3.709,258393,371981,113588,9.881,3.017,7917715,61.2,58.2,4848638,4606948,241690,5
Michigan,2017,3833766,153304,54639,1.425,22.226,16298,8.112,16612,8.269,200748,10202,10562,67620,129687,351007,480694,12.538,3.383,283304,426055,142751,11.113,3.724,7999550,61.4,58.6,4911247,4685853,225394,4.6
Michigan,2018,3886131,153645,76652,1.972,21.173,16379,8.155,15915,7.924,201082,10119,10371,68690,128250,359808,488058,12.559,3.3,277879,411406,133527,10.587,3.436,8029716,61.6,59,4944794,4739081,205713,4.2
Michigan,2019,3908231,153332,35297,0.903,19.696,16133,8.019,15702,7.805,201402,10706,10827,61662,112994,307185,420179,10.751,2.891,279996,384882,104886,9.848,2.684,8049908,61.9,59.3,4979516,4776963,202553,4.1
Michigan,2020,3954734,151882,12411,0.314,21.352,16560,8.245,17595,8.76,200337,10817,11022,70532,141827,292783,434610,10.99,3.586,294027,422199,128172,10.676,3.241,8051841,60.4,54.3,4861572,4376032,485540,10
Michigan,2021,3856017,150828,-204247,-5.297,20.469,20357,10.154,20018,9.985,200657,11430,11933,66817,136505,258138,394643,10.234,3.54,460609,598890,138281,15.531,3.586,8043807,59.4,56,4775153,4500849,274304,5.7
Michigan,2022,3827933,153773,149717,3.911,22.329,21148,10.468,18283,9.05,203460,12020,12448,69959,136764,440319,577083,15.076,3.573,285716,427366,141650,11.164,3.7,8057758,60.4,57.9,4866063,4664171,201892,4.1
Minnesota,1978,1304244,67859,139291,10.68,23.133,11004,14.065,7650,9.778,79914,5294,5368,27401,81586,208560,290146,22.246,6.255,91478,150855,59377,11.566,4.553,2907500,68,65.3,1976473,1899022,77451,3.9
Minnesota,1979,1429287,70611,90258,6.315,24.571,10451,12.8,7584,9.289,83079,5381,5430,29124,79595,186260,265855,18.601,5.569,122558,175597,53039,12.286,3.711,2957083,69.2,66.2,2045186,1957226,87960,4.3
Minnesota,1980,1480431,71545,12067,0.815,28.381,9413,11.241,8264,9.869,84313,5970,6058,34770,70507,151644,222151,15.006,4.763,147714,210084,62370,14.191,4.213,3008583,69.9,65.8,2101518,1980163,121355,5.8
Minnesota,1981,1478623,71698,-12320,-0.833,28.768,9310,11.011,8658,10.24,84875,6032,6139,36302,76216,136468,212684,14.384,5.155,158254,225004,66750,15.217,4.514,3045250,70.3,66.3,2142179,2018612,123567,5.8
Minnesota,1982,1457578,71032,-31731,-2.177,27.629,9084,10.715,9411,11.101,84613,6617,6678,34778,71134,130225,201359,13.815,4.88,169517,233090,63573,15.992,4.362,3069750,70.4,64.8,2160876,1989883,170993,7.9
Minnesota,1983,1430234,72504,-27541,-1.926,29.072,9861,11.548,8439,9.882,86105,5729,5811,31478,79573,128328,207901,14.536,5.564,169301,235442,66141,16.462,4.624,3085417,70.6,65,2177919,2005574,172345,7.9
Minnesota,1984,1465937,75711,100569,6.86,23.034,11683,13.294,8252,9.39,89595,5809,5932,35270,87118,182282,269400,18.377,5.943,106453,168831,62378,11.517,4.255,3105000,71.4,66.9,2216438,2077209,139229,6.3
Minnesota,1985,1550665,76338,69022,4.451,27.394,11182,12.429,10415,11.576,90351,7510,7673,53298,92570,188846,281416,18.148,5.97,121822,212394,90572,13.697,5.841,3122250,71.6,67.3,2235179,2100173,135006,6
Minnesota,1986,1589240,77059,7914,0.498,31.033,11446,12.575,10141,11.141,91673,7142,7284,53903,90322,164189,254511,16.015,5.683,161150,246597,85447,15.517,5.377,3162333,71.2,67.3,2253043,2127559,125484,5.6
Minnesota,1987,1626579,78085,58998,3.627,28.961,11869,12.827,10142,10.96,93398,6894,7019,46875,111740,182793,294533,18.108,6.87,149454,235535,86081,14.48,5.292,3198333,71.5,67.9,2286883,2170398,116485,5.1
Minnesota,1988,1684005,79584,47106,2.797,28.857,11915,12.587,9722,10.27,95759,6737,6865,48226,109804,180280,290084,17.226,6.52,155688,242978,87290,14.429,5.183,3240500,71.4,68.3,2312775,2212985,99790,4.3
Minnesota,1989,1738146,81092,66401,3.82,25.879,11691,12.07,9583,9.894,97910,6580,6752,45553,98152,193159,291311,16.76,5.647,135233,224910,89677,12.94,5.159,3268417,71.6,68.5,2340609,2238664,101945,4.4
Minnesota,1990,1800743,82841,53565,2.975,24.822,11330,11.449,9263,9.36,99993,6514,6657,42558,89365,187693,277058,15.386,4.963,146365,223493,77128,12.411,4.283,3270576,73.3,69.9,2397175,2284882,112293,4.7
Minnesota,1991,1812185,83430,-22008,-1.214,28.967,11942,11.841,9868,9.784,101892,6883,7070,57239,100836,161636,262472,14.484,5.564,188811,284480,95669,15.698,5.279,3308424,73.4,69.7,2429956,2305657,124299,5.1
Minnesota,1992,1817434,84150,38477,2.117,26.795,11262,11.004,10064,9.833,102948,6491,6683,44231,92077,189887,281964,15.514,5.066,161025,243487,82462,13.397,4.537,3345228,73.7,70,2464739,2340499,124240,5
Minnesota,1993,1864500,86784,62704,3.363,23.915,11359,10.897,8729,8.374,105558,5735,5958,36378,92465,193187,285652,15.321,4.959,151216,222948,71732,11.958,3.847,3393198,74.1,70.5,2514127,2392688,121439,4.8
Minnesota,1994,1939986,89178,59747,3.08,23.238,11928,11.122,8931,8.327,108746,6142,6302,40663,92214,192944,285158,14.699,4.753,151844,225411,73567,11.619,3.792,3440836,75,72,2580734,2476739,103995,4
Minnesota,1995,2006306,91262,76503,3.813,21.688,11832,10.754,9242,8.4,111317,6344,6534,39426,98481,195586,294067,14.657,4.909,149551,217564,68013,10.844,3.39,3489057,75.3,72.5,2626976,2530355,96621,3.7
Minnesota,1996,2054839,92794,55404,2.696,23.348,12033,10.74,9527,8.503,113297,6600,6772,46403,100191,195094,295285,14.37,4.876,165970,239881,73911,11.674,3.597,3540527,75.2,72.4,2664152,2562942,101210,3.8
Minnesota,1997,2117931,94537,56596,2.672,26.459,12844,11.229,10753,9.401,115424,6876,7107,49001,108926,227861,336787,15.902,5.143,179307,280191,100884,13.229,4.763,3585081,74.9,72.5,2686557,2600133,86424,3.2
Minnesota,1998,2212900,97010,80870,3.654,24.167,12134,10.367,9842,8.409,118187,6452,6599,42145,106459,241809,348268,15.738,4.811,187983,267398,79415,12.084,3.589,3626469,74.9,72.9,2716371,2643596,72775,2.7
Minnesota,1999,2280957,98214,52682,2.31,24.833,12339,10.351,10381,8.708,120187,6710,6935,44983,115671,220229,335900,14.726,5.071,183287,283218,99931,12.417,4.381,3678689,74.7,72.7,2746980,2672723,74257,2.7
Minnesota,2000,2343163,99225,67284,2.872,23.927,11901,9.833,10440,8.626,121757,6877,7085,43790,105287,242321,347608,14.835,4.493,196310,280324,84014,11.963,3.585,3730567,75,72.8,2799111,2714001,85110,3
Minnesota,2001,2374547,99862,2326,0.098,27.715,12945,10.558,11124,9.073,123515,6978,7206,49725,123006,208374,331380,13.956,5.18,219936,329054,109118,13.858,4.595,3780198,75.3,72.5,2847955,2740867,107088,3.8
Minnesota,2002,2374398,99773,-40844,-1.72,30.178,13885,11.191,13436,10.829,124302,7764,7991,60875,133366,224912,358278,15.089,5.617,273323,399122,125799,16.809,5.298,3823098,75.1,71.8,2873004,2744745,128259,4.5
Minnesota,2003,2358557,101329,14271,0.605,28.344,13878,11.084,11996,9.581,126145,7181,7281,41754,124865,223659,348524,14.777,5.294,226130,334253,108123,14.172,4.584,3859916,75,71.4,2893369,2754850,138519,4.8
Minnesota,2004,2373531,103311,10322,0.435,25.323,13916,10.929,11589,9.101,128498,7252,7425,45746,96934,213910,310844,13.096,4.084,198625,300522,101897,12.661,4.293,3893414,74.3,70.9,2893478,2760746,132732,4.6
Minnesota,2005,2397963,104699,39372,1.642,23.513,13608,10.515,11766,9.091,130342,7475,7575,43342,112569,208720,321289,13.398,4.694,195230,281917,86687,11.757,3.615,3928817,73.3,70.3,2880908,2762419,118489,4.1
Minnesota,2006,2444445,106078,52995,2.168,23.904,15548,11.798,12658,9.605,133235,8433,8577,48664,119128,226021,345149,14.12,4.873,197689,292154,94465,11.952,3.864,3971808,72.8,69.8,2889613,2772171,117442,4.1
Minnesota,2007,2489592,105830,41661,1.673,26.194,13991,10.506,13992,10.507,133168,8447,8541,46804,114380,253343,367723,14.77,4.594,220292,326062,105770,13.097,4.248,4013095,72.2,68.9,2898861,2765611,133250,4.6
Minnesota,2008,2499034,103991,-30548,-1.222,25.162,12341,9.328,13952,10.545,131500,8932,9142,52426,102810,211591,314401,12.581,4.114,242216,344949,102733,13.803,4.111,4050170,72,68.1,2914133,2756573,157560,5.4
Minnesota,2009,2433933,101438,-113527,-4.664,21.828,11042,8.459,13892,10.643,129103,8611,8797,48578,89136,176504,265640,10.914,3.662,293506,379167,85661,15.578,3.519,4083410,71.8,66.1,2932056,2699974,232082,7.9
Minnesota,2010,2363781,100260,-26270,-1.111,22.266,11067,8.607,12110,9.418,128060,7238,7376,40250,84371,178794,263165,11.133,3.569,203046,289435,86389,12.245,3.655,4115655,71.5,66.2,2940696,2722623,218073,7.4
Minnesota,2011,2370670,99863,40502,1.708,19.69,11530,9.003,11505,8.983,128087,7189,7391,38328,75679,198217,273896,11.554,3.192,164558,233394,68836,9.845,2.904,4150150,71.1,66.5,2952527,2760400,192127,6.5
Minnesota,2012,2424301,100283,69474,2.866,19.81,11335,8.839,10971,8.555,128423,6442,6640,42585,74231,235364,309595,12.77,3.062,163601,240121,76520,9.905,3.156,4184426,70.5,66.5,2949770,2783181,166589,5.6
Minnesota,2013,2488772,100317,36742,1.476,21.222,11188,8.696,10615,8.251,128944,6393,6451,35415,78815,222006,300821,12.087,3.167,193077,264079,71002,10.611,2.853,4218760,70.2,66.7,2961729,2812453,149276,5
Minnesota,2014,2533612,100841,47825,1.888,18.857,11516,8.879,10075,7.768,130425,6293,6432,40136,81507,205197,286704,11.316,3.217,167163,238879,71716,9.428,2.831,4252305,70.1,67.1,2979798,2852488,127310,4.3
Minnesota,2015,2556625,101439,43907,1.717,19.97,11740,8.954,10405,7.936,131778,6405,6602,35916,90827,208356,299183,11.702,3.553,183210,255276,72066,9.985,2.819,4282726,70.2,67.5,3005414,2891673,113741,3.8
Minnesota,2016,2601233,102274,49394,1.899,20.415,12024,9.054,9942,7.486,133843,6536,6661,43937,95662,219256,314918,12.106,3.678,183536,265524,81988,10.208,3.152,4318608,70,67.3,3023110,2906348,116762,3.9
Minnesota,2017,2638984,102576,33500,1.269,22.466,11522,8.593,11036,8.23,134332,6681,6840,41525,107293,222643,329936,12.502,4.066,202897,296436,93539,11.233,3.545,4379847,70.1,67.7,3071006,2963830,107176,3.5
Minnesota,2018,2675683,102125,39667,1.482,20.543,10638,7.94,11193,8.354,133708,6859,7040,47744,81437,233065,314502,11.754,3.044,183298,274835,91537,10.272,3.421,4418073,69.6,67.5,3075090,2982658,92432,3
Minnesota,2019,2694615,102052,1615,0.06,20.366,10770,8.044,10416,7.779,134072,6844,6997,41713,82989,193012,276001,10.243,3.08,195953,274386,78433,10.183,2.911,4453257,69.9,67.6,3111674,3009672,102002,3.3
Minnesota,2020,2701107,101688,10521,0.39,19.859,11044,8.241,11180,8.343,133942,6962,7190,41765,78652,200074,278726,10.319,2.912,187401,268205,80804,9.929,2.992,4476240,69.7,65.4,3122016,2926644,195372,6.3
Minnesota,2021,2648509,102807,-117303,-4.429,20.46,12409,9.228,11333,8.428,135011,6938,7144,38631,78084,192859,270943,10.23,2.948,303466,388246,84780,14.659,3.201,4492848,67.9,65.3,3049037,2935653,113384,3.7
Minnesota,2022,2641171,103571,103339,3.913,21.716,13180,9.728,12196,9.001,135981,8207,8494,44552,92381,297731,390112,14.77,3.498,189402,286773,97371,10.858,3.687,4504975,68.2,66.4,3071450,2992787,78663,2.6
Mississippi,1978,583954,35818,47267,8.094,26.296,6420,15.559,5010,12.142,41966,3508,3532,17157,42748,81296,124044,21.242,7.32,46207,76777,30570,13.148,5.235,1722000,58.7,54.7,1010650,942275,68375,6.8
Mississippi,1979,619036,37030,21035,3.398,28.642,6148,14.382,4776,11.173,43433,3426,3454,17473,37334,72353,109687,17.719,6.031,58138,88652,30514,14.321,4.929,1748333,58.5,55.1,1022603,964059,58544,5.7
Mississippi,1980,624327,37398,-9889,-1.584,29.787,5702,13.045,5176,11.842,43972,3804,3833,18141,34302,58681,92983,14.893,5.494,72162,102872,30710,16.477,4.919,1771000,59.3,54.9,1050404,972664,77740,7.4
Mississippi,1981,619655,37030,-2059,-0.332,28.954,5236,11.925,5329,12.137,43861,4074,4123,18263,32090,57619,89709,14.477,5.179,65995,91768,25773,14.81,4.159,1794583,58.8,53.8,1054711,964835,89876,8.5
Mississippi,1982,613099,35986,-15444,-2.519,27.798,5020,11.556,5893,13.566,43003,4178,4207,20890,31744,53470,85214,13.899,5.178,67687,100658,32971,16.418,5.378,1814083,58.7,52.3,1065524,948489,117035,11
Mississippi,1983,594906,36289,-17750,-2.984,30.031,5565,12.941,5556,12.92,43007,3620,3671,17091,32270,57057,89327,15.015,5.424,65035,107077,42042,17.999,7.067,1825750,58.7,51.7,1071360,943119,128241,12
Mississippi,1984,611049,38387,49196,8.051,23.346,6922,15.636,4436,10.02,45514,3349,3379,15430,45824,74699,120523,19.724,7.499,48002,71327,23325,11.673,3.817,1840417,59,52.7,1085823,970617,115206,10.6
Mississippi,1985,640810,38400,9842,1.536,30.247,5998,13.149,5802,12.72,45713,4179,4236,22754,38344,68412,106756,16.66,5.984,59325,96914,37589,15.124,5.866,1864583,60.2,53.9,1122529,1005323,117206,10.4
Mississippi,1986,658972,38898,22953,3.483,30.307,6022,13.073,5319,11.547,46416,3726,3778,19514,42510,80300,122810,18.637,6.451,66219,99857,33638,15.153,5.105,1868583,61.6,54.6,1150627,1019567,131060,11.4
Mississippi,1987,675323,38963,3482,0.516,33.942,6164,13.239,5911,12.696,46686,4042,4093,21835,47119,70973,118092,17.487,6.977,73113,114610,41497,16.971,6.145,1877167,61.3,55.1,1151209,1035217,115992,10.1
Mississippi,1988,690572,39134,21104,3.056,29.414,6105,13.003,5703,12.147,47151,3903,3956,22958,52014,70653,122667,17.763,7.532,62609,101563,38954,14.707,5.641,1885667,60.7,55.5,1144961,1047187,97774,8.5
Mississippi,1989,709742,39491,16598,2.339,28.155,6100,12.842,5401,11.37,47850,3800,3866,21518,43167,73345,116512,16.416,6.082,63299,99914,36615,14.078,5.159,1893583,61.4,56.6,1163521,1071801,91720,7.9
Mississippi,1990,728225,39969,19592,2.69,26.547,5999,12.453,5371,11.15,48486,3901,3988,21281,42176,74078,116254,15.964,5.792,62532,96662,34130,13.274,4.687,1894246,62.2,57.5,1178449,1089126,89323,7.6
Mississippi,1991,739963,39787,1613,0.218,30.348,5926,12.189,5545,11.405,48809,3891,3941,22930,43969,69926,113895,15.392,5.942,76354,112282,35928,15.174,4.855,1915135,61.8,56.6,1183892,1084601,99291,8.4
Mississippi,1992,745373,40008,12499,1.677,27.726,5446,11.138,5213,10.662,49012,3464,3533,19548,33539,82291,115830,15.54,4.5,68454,103331,34877,13.863,4.679,1928941,61.8,56.9,1192623,1097400,95223,8
Mississippi,1993,763995,41045,33298,4.358,25.892,5875,11.851,4745,9.571,50140,3353,3393,23130,46896,85308,132204,17.304,6.138,61399,98906,37507,12.946,4.909,1950747,62.2,58,1212765,1131370,81395,6.7
Mississippi,1994,804863,41672,41168,5.115,25.04,5968,11.792,5227,10.328,50981,3799,3883,19799,52984,88952,141936,17.635,6.583,67747,100768,33021,12.52,4.103,1975803,62.9,59,1243756,1165206,78550,6.3
Mississippi,1995,839640,42520,35559,4.235,25.395,6132,11.896,4981,9.663,52121,3587,3691,21963,53603,88569,142172,16.933,6.384,69471,106613,37142,12.697,4.424,2002192,62.7,58.8,1254599,1176966,77633,6.2
Mississippi,1996,851870,42932,6445,0.757,29.088,6114,11.665,5205,9.931,52866,3796,3861,24640,53845,76498,130343,15.301,6.321,81508,123898,42390,14.544,4.976,2025415,62.4,58.6,1263385,1187620,75765,6
Mississippi,1997,872440,43258,23560,2.7,28.071,6223,11.699,5580,10.49,53514,3869,3923,21507,47860,98152,146012,16.736,5.486,83550,122452,38902,14.036,4.459,2046888,62.2,58.6,1272835,1200405,72430,5.7
Mississippi,1998,924386,43704,26512,2.868,24.57,5957,11.036,5401,10.006,54254,3732,3818,22444,46715,93357,140072,15.153,5.054,74242,113560,39318,12.285,4.253,2067694,61.7,58.5,1276022,1208993,67029,5.3
Mississippi,1999,939117,43769,4759,0.507,28,5949,10.928,5651,10.381,54586,3930,4005,23946,44108,92126,136234,14.507,4.697,82798,131475,48677,14,5.183,2084667,61.6,58.4,1283790,1218258,65532,5.1
Mississippi,2000,949873,43263,11845,1.247,25.696,5589,10.245,5695,10.439,54503,3852,3949,22525,47812,86073,133885,14.095,5.034,79986,122040,42054,12.848,4.427,2096381,62.5,59.1,1309882,1239841,70041,5.3
Mississippi,2001,939678,42663,-37269,-3.966,26.482,5598,10.317,6055,11.16,54030,3844,4008,29107,48217,76205,124422,13.241,5.131,101487,161691,60204,17.207,6.407,2104190,61.5,58.1,1294733,1223536,71197,5.5
Mississippi,2002,919285,42929,-11916,-1.296,31.038,6212,11.421,5800,10.664,54597,3556,3625,24973,57146,85518,142664,15.519,6.216,102331,154580,52249,16.815,5.684,2111954,61.1,57.2,1290793,1207799,82994,6.4
Mississippi,2003,915146,43271,3627,0.396,29.834,5839,10.653,5389,9.832,55034,3518,3565,21611,49419,90721,140140,15.313,5.4,91148,136513,45365,14.917,4.957,2120642,61.5,57.7,1304578,1224551,80027,6.1
Mississippi,2004,923651,43657,13432,1.454,26.071,5638,10.191,5064,9.154,55609,3405,3466,19538,45571,88262,133833,14.49,4.934,79378,120401,41023,13.035,4.441,2135239,61.6,57.8,1314982,1234123,80859,6.1
Mississippi,2005,927949,43686,-4687,-0.505,26.917,5749,10.311,5452,9.778,55905,3576,3650,22619,43049,81838,124887,13.458,4.639,86985,129574,42589,13.963,4.59,2143324,61.5,56.8,1317407,1217359,100048,7.6
Mississippi,2006,936723,43369,18206,1.944,27.692,6272,11.209,6174,11.033,56006,3977,4050,21447,54665,93240,147905,15.79,5.836,87290,129699,42409,13.846,4.527,2148646,59.6,55.8,1280618,1199290,81328,6.4
Mississippi,2007,942349,44105,-5971,-0.634,27.82,6454,11.415,5276,9.332,57127,3528,3597,19820,41669,89412,131081,13.91,4.422,96330,137052,40722,14.544,4.321,2171648,59.6,55.9,1293338,1213549,79789,6.2
Mississippi,2008,940260,43626,4984,0.53,26.938,5328,9.348,5543,9.725,56889,3802,3892,20863,42046,89582,131628,13.999,4.472,84574,126644,42070,13.469,4.474,2186906,59.1,55.2,1293375,1206858,86517,6.7
Mississippi,2009,924777,42678,-45583,-4.929,22.751,4694,8.294,5763,10.183,56058,3909,4040,27355,44033,61164,105197,11.375,4.761,106181,150780,44599,16.304,4.823,2199696,57.7,52.3,1268505,1149831,118674,9.4
Mississippi,2010,891913,42136,-19890,-2.23,21.481,4505,8.073,5037,9.026,55538,3308,3395,18466,32325,63469,95794,10.74,3.624,83200,115684,32484,12.97,3.642,2228132,58.8,52.8,1309128,1176938,132190,10.1
Mississippi,2011,887797,41745,11384,1.282,21.787,4668,8.415,4801,8.655,55406,3158,3292,16906,34138,73960,108098,12.176,3.845,67898,96714,28816,10.894,3.246,2245128,60,54.1,1345990,1214638,131352,9.8
Mississippi,2012,896103,41381,5797,0.647,21.4,4383,7.935,4670,8.454,55094,2987,3051,14954,29754,71927,101681,11.347,3.32,69616,95884,26268,10.7,2.931,2254011,59,53.8,1330450,1213245,117205,8.8
Mississippi,2013,896718,41110,3342,0.373,21.063,4258,7.75,4418,8.041,54861,2906,2954,16991,29757,68022,97779,10.904,3.318,66879,94437,27558,10.531,3.073,2264123,56.2,51.4,1273057,1164832,108225,8.5
Mississippi,2014,903385,41073,10336,1.144,19.665,4414,8.029,4214,7.665,55075,2811,2865,14425,31271,67891,99162,10.977,3.462,63100,88826,25726,9.833,2.848,2272489,54.7,50.6,1243934,1149277,94657,7.6
Mississippi,2015,917186,40893,17769,1.937,20.845,4308,7.822,4317,7.838,55071,2858,2914,16397,42558,70803,113361,12.36,4.64,68715,95592,26877,10.422,2.93,2278953,55.3,51.7,1260015,1178018,81997,6.5
Mississippi,2016,932576,40916,12217,1.31,20.67,4447,8.053,4161,7.535,55363,2706,2780,14157,33812,74785,108597,11.645,3.626,68469,96380,27911,10.335,2.993,2285176,55.7,52.3,1271836,1196241,75595,5.9
Mississippi,2017,936125,40820,2947,0.315,22.475,4406,7.961,4414,7.976,55338,2754,2828,15007,32283,75863,108146,11.553,3.449,73840,105199,31359,11.238,3.35,2284344,55.7,52.8,1272685,1206102,66583,5.2
Mississippi,2018,942460,40785,1842,0.195,21.874,4263,7.704,4277,7.729,55330,2701,2800,16292,30916,74004,104920,11.133,3.28,72876,103078,30202,10.937,3.205,2280313,55.6,52.9,1268040,1205342,62698,4.9
Mississippi,2019,950440,40778,13661,1.437,18.853,4213,7.602,4060,7.326,55496,2802,2841,14635,31727,71525,103252,10.864,3.338,63931,89591,25660,9.426,2.7,2280145,56.1,53,1278958,1208541,70417,5.5
Mississippi,2020,954703,40405,-5011,-0.525,20.714,4236,7.653,4528,8.181,55204,2846,2875,16079,30383,68497,98880,10.357,3.182,71730,103891,32161,10.882,3.369,2276298,54.7,50.3,1244316,1145184,99132,8
Mississippi,2021,942421,40955,-19754,-2.096,21.476,5009,9.045,4655,8.406,55553,2795,3130,14460,31814,69382,101196,10.738,3.376,92013,120950,28937,12.834,3.07,2273021,55.1,52.1,1251894,1183867,68027,5.4
Mississippi,2022,937943,41077,10034,1.07,24.188,5200,9.344,4997,8.979,55753,3425,3543,17793,33881,89590,123471,13.164,3.612,79449,113437,33988,12.094,3.624,2272381,54.9,52.8,1248093,1200234,47859,3.8
Missouri,1978,1526711,81214,122817,8.045,25.144,13714,14.422,10877,11.439,96508,7433,7573,37272,97078,217677,314755,20.617,6.359,119614,191938,72324,12.572,4.737,3581750,63.2,60.1,2263749,2152914,110835,4.9
Missouri,1979,1631026,83847,73212,4.489,24.875,13029,13.276,10335,10.531,99486,7336,7423,37808,84137,191935,276072,16.926,5.159,135042,202860,67818,12.438,4.158,3620750,63.7,60.6,2305682,2195930,109752,4.8
Missouri,1980,1658694,83801,-20113,-1.213,27.642,11519,11.57,11423,11.474,99603,8230,8326,38616,78538,150708,229246,13.821,4.735,175655,249359,73704,15.033,4.443,3660917,63.7,59.2,2332959,2165751,167208,7.2
Missouri,1981,1642171,83658,-8104,-0.493,28.875,11638,11.675,11290,11.326,99857,8189,8306,41192,93354,143735,237089,14.438,5.685,167984,245193,77209,14.931,4.702,3687250,63,58.2,2324577,2144992,179585,7.7
Missouri,1982,1625141,81840,-22058,-1.357,28.835,11136,11.23,12581,12.688,98437,8820,8938,43941,83896,150408,234304,14.417,5.162,177049,256362,79313,15.775,4.88,3702167,62.9,57,2327275,2111562,215713,9.3
Missouri,1983,1608553,83976,-13149,-0.817,30.677,12911,12.974,10908,10.961,100519,7424,7555,39616,82210,164515,246725,15.338,5.111,178524,259874,81350,16.156,5.057,3728167,63.3,57,2359711,2125008,234703,9.9
Missouri,1984,1646316,86774,96370,5.854,25.062,14282,13.984,11171,10.938,103688,8112,8217,42119,101150,201521,302671,18.385,6.144,133994,206301,72307,12.531,4.392,3756417,63.3,58.6,2376245,2200916,175329,7.4
Missouri,1985,1716762,88146,45975,2.678,28.648,13840,13.254,12330,11.808,105176,8900,9040,57548,99708,192173,291881,17.002,5.808,137791,245906,108115,14.324,6.298,3777667,64.6,60.3,2438500,2276927,161573,6.6
Missouri,1986,1768883,89911,59494,3.363,28.966,14769,13.866,11970,11.238,107909,8547,8764,54029,119691,195992,315683,17.846,6.766,163493,256189,92696,14.483,5.24,3821750,65.6,61.4,2505407,2345518,159889,6.4
Missouri,1987,1825941,91543,49847,2.73,32.408,15275,13.987,12759,11.684,110463,8752,8908,57586,136731,208992,345723,18.934,7.488,185916,295876,109960,16.204,6.022,3866583,66.1,61.9,2555877,2395244,160633,6.3
Missouri,1988,1854291,93142,30148,1.626,30.731,14883,13.308,12471,11.151,113044,8700,8841,52086,116420,198648,315068,16.991,6.278,183578,284920,101342,15.365,5.465,3897000,66.5,62.7,2590805,2443392,147413,5.7
Missouri,1989,1903181,95145,67242,3.533,27.942,14803,12.936,12174,10.638,115748,8601,8833,57686,110016,223116,333132,17.504,5.781,170151,265890,95739,13.971,5.03,3910500,67.2,63.5,2627403,2482227,145176,5.5
Missouri,1990,1960342,96753,44319,2.261,26.646,14067,12.051,12172,10.428,117674,8605,8827,51330,108888,196609,305497,15.584,5.555,176088,261178,85090,13.323,4.341,3861197,67.5,63.5,2607053,2452698,154355,5.9
Missouri,1991,1954152,96092,-31405,-1.607,28.669,14123,11.974,13215,11.204,118402,9251,9519,64496,114193,165928,280121,14.335,5.844,202425,311526,109101,15.942,5.583,3892925,67.6,63.2,2633463,2460843,172620,6.6
Missouri,1992,1965575,96594,21357,1.087,27.541,13317,11.23,12717,10.724,118885,8236,8415,43526,97898,194126,292024,14.857,4.981,181053,270667,89614,13.77,4.559,3921321,67.4,63.2,2642439,2479416,163023,6.2
Missouri,1993,1988319,98721,30366,1.527,26.389,13479,11.251,11600,9.683,120739,7852,8028,46581,93004,199712,292716,14.722,4.678,179378,262350,82972,13.195,4.173,3962466,67.8,63.6,2686624,2519588,167036,6.2
Missouri,1994,2038978,100779,57868,2.838,25.75,14650,11.989,12140,9.935,123447,8542,8759,50563,106759,213631,320390,15.713,5.236,169494,262522,93028,12.875,4.562,4006945,68.4,64.9,2740827,2598977,141850,5.2
Missouri,1995,2100061,102733,68434,3.259,25.584,14709,11.797,12197,9.782,125940,8637,8859,50576,109722,227348,337070,16.05,5.225,176210,268636,92426,12.792,4.401,4048757,70.1,66.8,2839875,2703585,136290,4.8
Missouri,1996,2124347,103387,34139,1.607,26.973,14215,11.25,12236,9.683,127349,8894,9045,50051,112596,208045,320641,15.094,5.3,195793,286502,90709,13.487,4.27,4091569,70.7,67.4,2893926,2757151,136775,4.7
Missouri,1997,2180130,103350,65053,2.984,27.487,14198,11.138,14012,10.992,127571,9571,9861,55185,118239,246443,364682,16.728,5.423,196635,299629,102994,13.744,4.724,4132214,70.9,67.8,2930806,2803232,127574,4.4
Missouri,1998,2269867,104446,36693,1.617,26.176,13829,10.744,12608,9.796,129321,8452,8643,47227,117607,216168,333775,14.705,5.181,206002,297082,91080,13.088,4.013,4165026,70.7,67.9,2946188,2827027,119161,4
Missouri,1999,2311822,104636,37047,1.603,26.555,13626,10.501,12830,9.888,130156,8634,8832,48897,111408,232589,343997,14.88,4.819,199241,306950,107709,13.277,4.659,4201421,70.1,67.9,2946949,2852074,94875,3.2
Missouri,2000,2357309,104661,43407,1.841,26.382,13454,10.307,12822,9.822,130854,8638,8841,48839,113735,240619,354354,15.032,4.825,209672,310947,101275,13.191,4.296,4235660,70.2,67.8,2971441,2870458,100983,3.4
Missouri,2001,2373575,103460,-8646,-0.364,27.866,12658,9.703,13307,10.2,130131,8665,8892,53732,114053,216660,330713,13.933,4.805,220439,339359,118920,14.297,5.01,4272691,69.9,66.8,2987905,2853157,134748,4.5
Missouri,2002,2361022,104204,-45581,-1.931,31.514,15660,11.946,14473,11.04,131687,8675,8912,71293,151180,220843,372023,15.757,6.403,275286,417604,142318,17.687,6.028,4310430,69.2,65.5,2981097,2823361,157736,5.3
Missouri,2003,2354432,105851,33697,1.431,26.282,15272,11.517,13330,10.053,133574,8672,8897,49551,103358,239734,343092,14.572,4.39,206883,309395,102512,13.141,4.354,4346056,68.6,64.8,2983337,2814661,168676,5.7
Missouri,2004,2386989,108337,25793,1.081,26.649,15965,11.827,13130,9.726,136410,8802,8923,50080,120499,223348,343847,14.405,5.048,203916,318054,114138,13.324,4.782,4386582,68.3,64.3,2995924,2819803,176121,5.9
Missouri,2005,2396663,110190,-7523,-0.314,25.776,16045,11.652,13464,9.777,138998,9316,9482,51485,111885,196993,308878,12.888,4.668,227304,316401,89097,13.202,3.718,4435045,67.9,64.2,3011096,2847795,163301,5.4
Missouri,2006,2418115,109544,52245,2.161,25.2,16434,11.784,15456,11.083,139948,11055,11263,52512,132282,224641,356923,14.76,5.47,204507,304678,100171,12.6,4.143,4487608,67.7,64.4,3036656,2888798,147858,4.9
Missouri,2007,2439484,108891,-10075,-0.413,27.481,15228,10.875,14873,10.622,140203,9900,10098,52292,115595,219600,335195,13.74,4.739,236746,345270,108524,14.153,4.449,4532828,67.5,64,3058119,2902504,155615,5.1
Missouri,2008,2437987,107132,11341,0.465,26.152,13362,9.579,14607,10.471,138873,9805,9939,47735,111462,218667,330129,13.541,4.572,217993,318788,100795,13.076,4.134,4576051,67,62.8,3065251,2875600,189651,6.2
Missouri,2009,2388606,104476,-109088,-4.567,21.916,12093,8.779,15214,11.044,136196,10098,10294,59142,91230,170515,261745,10.958,3.819,257635,370833,113198,15.525,4.739,4610127,66.4,60.4,3061704,2784890,276814,9
Missouri,2010,2306071,103558,-57837,-2.508,22.192,13060,9.623,13996,10.313,135247,8817,9056,44000,91706,164176,255882,11.096,3.977,229779,313719,83940,13.604,3.64,4629450,65.7,59.5,3043249,2753910,289339,9.5
Missouri,2011,2278063,101380,275,0.012,22.112,12341,9.196,13392,9.979,133671,9052,9252,41371,76418,175716,252134,11.068,3.355,176722,251859,75137,11.056,3.298,4648959,65.2,59.6,3032960,2770662,262298,8.6
Missouri,2012,2295707,101253,33385,1.454,22.21,12709,9.517,12944,9.693,133418,8205,8570,39103,84801,203526,288327,12.559,3.694,176006,254942,78936,11.105,3.438,4670471,64.3,59.7,3004347,2789025,215322,7.2
Missouri,2013,2332010,103148,32509,1.394,21.084,13776,10.224,12096,8.977,135583,7662,7825,38095,87511,190842,278353,11.936,3.753,166927,245844,78917,10.542,3.384,4690656,64.2,59.8,3011198,2807115,204083,6.8
Missouri,2014,2374906,105386,51874,2.184,19.713,14935,10.887,12238,8.921,138533,8064,8175,38062,85670,200289,285959,12.041,3.607,160575,234085,73510,9.857,3.095,4713011,64.4,60.4,3035599,2848571,187028,6.2
Missouri,2015,2422981,107635,45577,1.881,21.89,15469,11.05,12750,9.108,141351,8205,8413,42396,106063,204712,310775,12.826,4.377,177712,265198,87486,10.945,3.611,4735158,64.6,61.3,3057859,2901467,156392,5.1
Missouri,2016,2473127,109842,55449,2.242,19.672,15786,11.029,12350,8.628,144852,8346,8470,41627,97727,200981,298708,12.078,3.952,168561,243259,74698,9.836,3.02,4755612,64.6,61.7,3072904,2933457,139447,4.5
Missouri,2017,2506099,109976,29751,1.187,23.47,14606,10.098,14394,9.952,144745,8973,9181,46467,101946,221893,323839,12.922,4.068,192199,294088,101889,11.735,4.066,4775175,63.9,61.6,3053526,2939306,114220,3.7
Missouri,2018,2521273,104127,9249,0.367,22.993,13408,9.666,13397,9.658,138725,8760,8909,43485,90532,208572,299104,11.863,3.591,199956,289855,89899,11.496,3.566,4791474,63.6,61.6,3048449,2949963,98486,3.2
Missouri,2019,2535182,104433,19083,0.753,20.352,13351,9.625,12182,8.782,139293,8141,8262,40450,84996,192065,277061,10.929,3.353,175022,257978,82956,10.176,3.272,4812110,63.9,61.8,3073523,2973662,99861,3.2
Missouri,2020,2555238,103283,20893,0.818,20.691,12694,9.176,12719,9.194,138331,8282,8493,41025,104745,180495,285240,11.163,4.099,184891,264347,79456,10.345,3.11,4826935,62.7,58.8,3025785,2839617,186168,6.2
Missouri,2021,2515679,104279,-92424,-3.674,21.476,13749,9.924,12648,9.129,139098,8070,8340,45119,88860,181271,270131,10.738,3.532,272208,362555,90347,14.412,3.591,4847030,62.5,59.9,3028635,2902841,125794,4.2
Missouri,2022,2516775,104415,90267,3.587,23.222,14305,10.274,13566,9.744,139600,9448,9734,46302,106814,275671,382485,15.197,4.244,201921,292218,90297,11.611,3.588,4866531,62.4,60.8,3036611,2957352,79259,2.6
Montana,1978,186901,17368,22999,12.305,30.119,3354,17.403,2302,11.945,19798,1645,1651,7442,16828,34317,51145,27.365,9.004,14806,28146,13340,15.059,7.137,564667,64.5,60.9,364001,343753,20248,5.6
Montana,1979,206371,17956,13459,6.522,30.739,3180,15.779,2566,12.733,20460,1889,1900,8664,17557,27620,45177,21.891,8.508,19570,31718,12148,15.369,5.887,571917,64.5,61.2,368994,349806,19188,5.2
Montana,1980,210888,17977,-4729,-2.242,34.513,2698,13.18,2686,13.122,20476,1920,1930,8891,14656,21736,36392,17.257,6.95,27855,41121,13266,19.499,6.291,574833,64.7,60.6,372131,348596,23535,6.3
Montana,1981,208549,18114,-40,-0.019,36.422,2754,13.396,2580,12.549,20646,1871,1889,8304,14414,23565,37979,18.211,6.912,24587,38019,13432,18.23,6.441,581667,65.8,61.3,382677,356847,25830,6.7
Montana,1982,205793,17886,-5464,-2.655,34.948,2672,12.993,2835,13.785,20484,1987,2002,9366,14253,21707,35960,17.474,6.926,27927,41424,13497,20.129,6.559,588250,66,60.3,388163,354790,33373,8.6
Montana,1983,201401,18352,-3979,-1.976,35.738,2912,14.049,2426,11.705,20970,1679,1705,8800,14957,21031,35988,17.869,7.426,26344,39967,13623,19.844,6.764,596250,66.4,60.6,395691,361054,34637,8.8
Montana,1984,203904,19297,8512,4.175,31.76,3348,15.589,2341,10.9,21980,1676,1696,7204,17555,23337,40892,20.055,8.609,21476,32380,10904,15.88,5.348,601417,67,62,402950,372766,30184,7.5
Montana,1985,207120,19234,-1881,-0.908,34.172,2862,13.062,2991,13.651,21846,2155,2166,9694,13055,22333,35388,17.086,6.303,21599,37269,15670,17.994,7.566,603250,67,61.9,404277,373145,31132,7.7
Montana,1986,204138,19064,-3975,-1.947,33.244,2881,13.208,2952,13.534,21777,2160,2179,9827,14245,19687,33932,16.622,6.978,24025,37907,13882,18.569,6.8,600333,67.3,62,404222,372088,32134,7.9
Montana,1987,203863,19024,2926,1.435,37.683,2978,13.672,2967,13.622,21787,2095,2113,9059,17411,23926,41337,20.277,8.541,22529,38411,15882,18.842,7.791,597500,67.2,62.2,401602,371489,30113,7.5
Montana,1988,206454,19092,-878,-0.425,36.738,2796,12.781,2687,12.283,21930,1863,1879,9010,14907,23016,37923,18.369,7.221,23283,38801,15518,18.794,7.516,596083,67.8,63.3,404209,377497,26712,6.6
Montana,1989,209504,19132,6732,3.213,29.056,2620,11.925,2566,11.679,21998,1790,1804,7845,12403,24766,37169,17.741,5.92,18459,30437,11978,14.528,5.717,596333,68.3,64.3,407527,383273,24254,6
Montana,1990,218486,19524,10080,4.614,25.744,2587,11.644,2186,9.84,22417,1560,1577,6340,12006,26197,38203,17.485,5.495,18219,28123,9904,12.872,4.533,595669,67.7,63.6,403230,378832,24398,6.1
Montana,1991,223796,19647,2129,0.951,30.709,2685,11.893,2267,10.041,22786,1636,1666,7992,14014,22478,36492,16.306,6.262,22984,34363,11379,15.355,5.085,602293,66.9,62.2,402858,374895,27963,6.9
Montana,1992,230048,20087,12081,5.252,27.686,2932,12.707,2306,9.994,23386,1531,1570,7158,14137,29790,43927,19.095,6.145,19182,31846,12664,13.843,5.505,612721,68.4,63.8,419070,391005,28065,6.7
Montana,1993,239353,20524,6288,2.627,28.482,2713,11.492,2276,9.641,23826,1564,1584,7018,12849,27525,40374,16.868,5.368,23222,34086,10864,14.241,4.539,626483,67.9,63.7,425278,399352,25926,6.1
Montana,1994,246279,21254,6576,2.67,27.794,2997,12.353,2240,9.233,24639,1591,1611,7123,15453,25349,40802,16.567,6.275,23390,34226,10836,13.897,4.4,640828,68.1,64.4,436529,412510,24019,5.5
Montana,1995,254369,21935,11791,4.635,24.549,3167,12.656,2345,9.371,25434,1670,1691,7639,16486,26527,43013,16.91,6.481,20061,31222,11161,12.274,4.388,655757,67.5,63.6,442616,417361,25255,5.7
Montana,1996,260952,22440,5083,1.948,27.881,3127,12.212,2589,10.111,25874,1728,1751,8404,15732,25729,41461,15.888,6.029,23039,36378,13339,13.94,5.112,667269,67.2,63.5,448336,423434,24902,5.6
Montana,1997,266764,22951,5502,2.063,31.042,3210,12.282,2702,10.338,26390,1819,1845,8639,16343,30564,46907,17.584,6.126,26661,41405,14744,15.521,5.527,673364,67.2,63.5,452633,427819,24814,5.5
Montana,1998,275530,23481,3271,1.187,30.041,3293,12.307,2752,10.285,27028,1905,1945,8383,16441,28216,44657,16.208,5.967,25022,41386,16364,15.021,5.939,676543,68.4,64.5,462542,436497,26045,5.6
Montana,1999,282479,23690,11553,4.09,25.986,3029,11.142,2742,10.087,27328,1862,1905,8530,16806,31450,48256,17.083,5.949,23267,36703,13436,12.993,4.756,680888,68.5,64.9,466729,441984,24745,5.3
Montana,2000,294126,23942,10726,3.647,25.85,3118,11.317,2722,9.88,27750,1852,1889,8278,15873,32868,48741,16.571,5.397,24261,38015,13754,12.925,4.676,686936,68.4,65.1,470069,447383,22686,4.8
Montana,2001,301493,24187,4037,1.339,28.509,3103,11.109,2752,9.852,28108,1771,1801,9176,16233,30780,47013,15.593,5.384,28316,42976,14660,14.254,4.862,693174,67.1,64,465355,443866,21489,4.6
Montana,2002,302201,24291,-3112,-1.03,33.182,3265,11.537,3108,10.982,28379,1834,1856,9366,19174,30964,50138,16.591,6.345,35363,53250,17887,17.621,5.919,700096,66.6,63.6,466408,445122,21286,4.6
Montana,2003,302845,24906,4676,1.544,28.172,3399,11.843,2733,9.523,29033,1744,1760,7555,16991,30344,47335,15.63,5.61,29280,42659,13379,14.086,4.418,708358,66.4,63.3,470502,448251,22251,4.7
Montana,2004,310291,25777,10625,3.424,24.574,3710,12.589,2812,9.542,29919,1787,1818,8555,16189,32561,48750,15.711,5.217,22606,38125,15519,12.287,5.001,718057,66.6,63.6,478226,456674,21552,4.5
Montana,2005,321146,26497,11512,3.585,25.24,3630,11.967,2820,9.297,30738,1858,1884,7605,21135,30906,52041,16.205,6.581,28517,40529,12012,12.62,3.74,728189,66.7,64,485546,465728,19818,4.1
Montana,2006,332876,27547,10418,3.13,26.96,4347,13.851,3052,9.725,32032,2070,2095,8730,21142,34148,55290,16.61,6.351,30909,44872,13963,13.48,4.195,739612,66.9,64.7,495166,478726,16440,3.3
Montana,2007,348131,28306,12211,3.508,26.435,4088,12.586,3124,9.618,32962,2090,2113,8870,19820,38406,58226,16.725,5.693,31439,46015,14576,13.218,4.187,750440,67.3,65,505095,488129,16966,3.4
Montana,2008,356458,28161,4832,1.356,26.493,3436,10.436,3490,10.6,32896,2387,2418,9865,16360,35691,52051,14.602,4.59,31431,47219,15788,13.247,4.429,759997,67.4,64.2,512278,488259,24019,4.7
Montana,2009,349704,27178,-19127,-5.469,22.199,2862,8.82,4010,12.358,31875,2537,2577,9678,12277,26538,38815,11.099,3.511,42458,57942,15484,16.569,4.428,767110,65.5,60.8,502593,466778,35815,7.1
Montana,2010,338770,26825,-3003,-0.886,25.45,2952,9.311,3302,10.415,31530,2072,2099,9471,16371,26738,43109,12.725,4.832,31987,46112,14125,13.612,4.169,777255,64.4,59.8,500895,464808,36087,7.2
Montana,2011,336369,26503,-1836,-0.546,24.365,3037,9.675,3312,10.551,31253,2051,2100,8592,12375,28603,40978,12.182,3.679,28809,42814,14005,12.728,4.164,784511,63.9,59.6,501065,467786,33279,6.6
Montana,2012,338618,26799,6682,1.973,22.672,3268,10.4,2915,9.277,31599,1749,1777,6776,14093,30974,45067,13.309,4.162,26382,38385,12003,11.336,3.545,791192,64,60.3,506441,477056,29385,5.8
Montana,2013,347258,26999,11052,3.183,21.841,3231,10.182,2955,9.312,31872,1871,1898,7817,17818,31156,48974,14.103,5.131,25235,37922,12687,10.92,3.653,799350,64,60.5,511199,483798,27401,5.4
Montana,2014,357574,27147,9606,2.686,21.882,3136,9.798,2880,8.999,32133,1835,1850,7544,14601,34127,48728,13.627,4.083,24238,39122,14884,10.941,4.163,806981,63.5,60.6,512613,488738,23875,4.7
Montana,2015,366902,27529,9622,2.622,21.379,3239,10.002,2769,8.551,32619,1844,1885,7720,15933,32909,48842,13.312,4.343,26751,39220,12469,10.69,3.398,814805,63.6,60.8,517901,495725,22176,4.3
Montana,2016,373226,27724,3879,1.039,21.717,3183,9.699,2777,8.462,33021,1853,1860,7185,15879,28527,44406,11.898,4.255,28411,40527,12116,10.859,3.246,824042,63.3,60.6,521736,499266,22470,4.3
Montana,2017,375428,27823,1951,0.52,24.998,2996,9.061,2895,8.756,33115,1803,1841,8697,14206,34669,48875,13.018,3.784,31402,46924,15522,12.499,4.134,836658,63.2,60.6,528441,506871,21570,4.1
Montana,2018,373307,28146,-6818,-1.826,24.244,3244,9.745,2889,8.678,33467,1832,1851,7838,15717,29536,45253,12.122,4.21,38142,52071,13929,13.949,3.731,845569,63.3,60.9,535140,515213,19927,3.7
Montana,2019,373803,28435,3806,1.018,20.884,3255,9.671,2870,8.527,33851,1920,1936,8223,14274,28564,42838,11.46,3.819,26690,39032,12342,10.442,3.302,854621,63.6,61.4,543914,524870,19044,3.5
Montana,2020,377604,28791,3312,0.877,22.16,3610,10.588,3107,9.112,34348,1961,1985,9324,16009,29141,45150,11.957,4.24,26477,41838,15361,11.08,4.068,864710,63,59.3,544500,512744,31756,5.8
Montana,2021,380991,29630,1434,0.376,24.252,3901,11.214,3032,8.716,35220,2025,2062,8754,15734,31899,47633,12.502,4.13,32403,46199,13796,12.126,3.621,881252,62.3,60.2,549105,530391,18714,3.4
Montana,2022,390778,30228,18200,4.657,23.422,4177,11.745,3450,9.701,35927,2519,2576,9954,22279,41685,63964,16.368,5.701,30518,45764,15246,11.711,3.901,897221,62.9,61.2,564052,548848,15204,2.7
Nebraska,1978,449212,31307,22774,5.07,27.423,4602,12.896,3666,10.273,36153,2636,2685,13821,27740,56627,84367,18.781,6.175,37895,61593,23698,13.711,5.275,1127167,66.7,64.7,752051,729647,22404,3
Nebraska,1979,476602,32372,27464,5.762,23.455,4434,12.059,3419,9.298,37278,2454,2473,12345,22780,60578,83358,17.49,4.78,36801,55894,19093,11.728,4.006,1137750,66.7,64.8,758381,736830,21551,2.8
Nebraska,1980,488281,32379,-4086,-0.837,28.921,4093,10.963,4003,10.722,37379,2981,3013,12867,25186,45421,70607,14.46,5.158,54148,74693,20545,15.297,4.208,1148083,66.5,64,763873,734867,29006,3.8
Nebraska,1981,490223,32426,8495,1.733,28.196,4026,10.749,3862,10.311,37536,2825,2860,13318,26266,51341,77607,15.831,5.358,47393,69112,21719,14.098,4.43,1158000,66.7,64,772523,740704,31819,4.1
Nebraska,1982,485530,31917,-17199,-3.542,26.711,3901,10.454,4357,11.676,37088,3090,3160,14189,24358,40488,64846,13.356,5.017,58480,82045,23565,16.898,4.853,1164250,67.2,63.5,782098,739337,42761,5.5
Nebraska,1983,472893,32375,-7862,-1.663,29.246,4238,11.359,3797,10.177,37531,2603,2634,12572,24025,45125,69150,14.623,5.08,51319,77012,25693,16.285,5.433,1173250,67.1,63.4,787703,743737,43966,5.6
Nebraska,1984,479695,33427,21552,4.493,25.569,4797,12.583,3655,9.588,38693,2664,2701,12926,32083,50796,82879,17.277,6.688,40897,61327,20430,12.785,4.259,1178667,67.1,64.1,790704,755315,35389,4.5
Nebraska,1985,494821,33064,6153,1.243,30.166,4368,11.343,4734,12.294,38325,3506,3547,21528,30687,50101,80788,16.327,6.202,40786,74635,33849,15.083,6.841,1172750,68.6,65.2,804954,764128,40826,5.1
Nebraska,1986,499866,32650,2046,0.409,29.694,4075,10.669,4368,11.436,38050,3173,3214,15913,28698,47564,76262,15.256,5.741,49822,74216,24394,14.847,4.88,1178500,69,65.7,813639,774352,39287,4.8
Nebraska,1987,508878,32554,12930,2.541,29.135,4203,11.034,4129,10.84,38128,2896,2936,16283,32175,54887,87062,17.109,6.323,44483,74132,29649,14.568,5.826,1182000,68.8,65.9,812800,778421,34379,4.2
Nebraska,1988,528540,32972,22743,4.303,25.831,4351,11.291,3664,9.508,38880,2564,2600,13850,30453,60554,91007,17.219,5.762,43383,68264,24881,12.916,4.708,1189167,68.7,66.3,816404,788223,28181,3.5
Nebraska,1989,551651,33302,23299,4.224,26.215,4359,11.13,3824,9.764,39431,2639,2711,16746,35295,60312,95607,17.331,6.398,42718,72308,29590,13.108,5.364,1193750,68.3,66.4,815765,792301,23464,2.9
Nebraska,1990,575140,33651,23727,4.125,21.932,4069,10.256,3589,9.046,39915,2545,2590,13507,30412,56385,86797,15.091,5.288,42852,63070,20218,10.966,3.515,1162187,70.9,69.3,824443,804948,19495,2.4
Nebraska,1991,585647,33627,2042,0.349,27.754,4294,10.693,3687,9.181,40462,2624,2684,19481,29070,54243,83313,14.226,4.964,52449,81271,28822,13.877,4.921,1174176,71.4,69.5,838758,816427,22331,2.7
Nebraska,1992,589603,33954,9086,1.541,24.859,4086,10.059,3736,9.197,40795,2459,2511,13588,27301,55071,82372,13.971,4.63,50432,73286,22854,12.43,3.876,1188101,71.4,69.4,848439,824364,24075,2.8
Nebraska,1993,602518,34403,16538,2.745,22.654,3962,9.66,3526,8.597,41232,2404,2480,11762,25312,59473,84785,14.072,4.201,47791,68247,20456,11.327,3.395,1201860,71.9,69.9,863879,839870,24009,2.8
Nebraska,1994,621904,34955,17741,2.853,23,4240,10.178,3550,8.521,42005,2518,2564,13344,30814,58445,89259,14.353,4.955,46250,71518,25268,11.5,4.063,1214368,72.9,71,885124,861870,23254,2.6
Nebraska,1995,643176,35358,26726,4.155,20.61,4085,9.656,3479,8.224,42607,2507,2560,12686,29006,63999,93005,14.46,4.51,45068,66279,21211,10.305,3.298,1230543,73.3,71.3,901405,877863,23542,2.6
Nebraska,1996,663054,35477,20186,3.044,22.066,4156,9.745,3729,8.744,42859,2651,2711,13961,31660,61680,93340,14.077,4.775,49645,73154,23509,11.033,3.546,1246385,73.4,71.4,914511,889935,24576,2.7
Nebraska,1997,677274,35789,6593,0.973,28.915,4396,10.216,4021,9.345,43216,2670,2748,16695,39444,65067,104511,15.431,5.824,65505,97918,32413,14.458,4.786,1257727,73.1,71.3,919274,896972,22302,2.4
Nebraska,1998,701088,36111,23875,3.405,23.055,4142,9.504,3853,8.841,43728,2623,2698,15142,31067,73625,104692,14.933,4.431,53216,80817,27601,11.527,3.937,1266318,73.2,71.3,926389,903089,23300,2.5
Nebraska,1999,721076,36254,13690,1.899,25.646,4000,9.116,3780,8.614,43990,2578,2670,20996,32739,73416,106155,14.722,4.54,56295,92465,36170,12.823,5.016,1275410,72.9,70.9,930022,904795,25227,2.7
Nebraska,2000,740234,36482,23639,3.193,23.668,4201,9.49,3682,8.317,44528,2411,2490,12353,37385,73852,111237,15.027,5.05,61217,87598,26381,11.834,3.564,1283772,73.1,71.1,938849,912620,26229,2.8
Nebraska,2001,746831,36536,-11519,-1.542,26.669,4247,9.506,4061,9.089,44771,2511,2603,15835,39098,60488,99586,13.334,5.235,74056,111105,37049,14.877,4.961,1290958,73.2,70.9,945374,915662,29712,3.1
Nebraska,2002,741326,36598,-1760,-0.237,30.734,4593,10.202,4330,9.618,45151,2576,2630,17520,45268,68652,113920,15.367,6.106,80552,115680,35128,15.604,4.739,1298974,73.4,70.7,952937,917833,35104,3.7
Nebraska,2003,749145,36955,17283,2.307,26.568,4452,9.811,3950,8.704,45630,2439,2478,12610,36574,80227,116801,15.591,4.882,68099,99518,31419,13.284,4.194,1307147,74,71.1,967039,928916,38123,3.9
Nebraska,2004,756897,37307,-832,-0.11,24.743,4230,9.231,3851,8.404,46013,2484,2544,13752,32220,61418,93638,12.371,4.257,70083,94470,24387,12.481,3.222,1315032,74,71.2,973636,935722,37914,3.9
Nebraska,2005,763947,37619,12762,1.671,23.864,4280,9.256,3849,8.324,46454,2491,2547,13503,32462,71453,103915,13.602,4.249,63940,91153,27213,11.932,3.562,1324178,73.5,70.7,972759,935914,36845,3.8
Nebraska,2006,777497,37784,13922,1.791,22.597,4859,10.387,4206,8.992,47104,2849,2915,14189,39391,62376,101767,13.089,5.066,61252,87845,26593,11.298,3.42,1333583,72.8,70.6,971430,941941,29489,3
Nebraska,2007,787838,37823,7071,0.898,24.625,4550,9.631,4226,8.945,47406,2693,2709,14489,32800,71274,104074,13.21,4.163,67133,97003,29870,12.313,3.791,1342436,72.9,70.8,979043,950318,28725,2.9
Nebraska,2008,794011,37613,474,0.06,25.269,4192,8.851,4235,8.941,47342,2753,2781,13983,28434,72360,100794,12.694,3.581,72536,100320,27784,12.635,3.499,1352164,73,70.7,987537,955470,32067,3.2
Nebraska,2009,787411,37349,-16654,-2.115,22.253,3748,7.923,4091,8.648,47133,2628,2683,16405,30241,57369,87610,11.126,3.841,72858,104264,31406,13.241,3.989,1363273,72.5,69.1,987855,941903,45952,4.7
Nebraska,2010,775189,37309,-10252,-1.323,20.57,3761,7.97,3670,7.777,47237,2237,2298,12004,23929,55798,79727,10.285,3.087,68744,89979,21235,11.607,2.739,1386390,71.6,68.2,992009,945195,46814,4.7
Nebraska,2011,756987,37069,3666,0.484,21.366,3888,8.238,3961,8.392,47161,2454,2503,12271,24167,60369,84536,11.167,3.193,56512,80870,24358,10.683,3.218,1399914,71.7,68.5,1003635,959325,44310,4.4
Nebraska,2012,766174,37386,15209,1.985,20.457,3922,8.291,3617,7.646,47458,2199,2243,11875,25891,67686,93577,12.214,3.379,56863,78368,21505,10.228,2.807,1410901,71.8,69,1012807,973448,39359,3.9
Nebraska,2013,776468,37336,3379,0.435,21.807,3838,8.079,3717,7.824,47566,2289,2315,12907,24841,63202,88043,11.339,3.199,58428,84664,26236,10.904,3.379,1420828,71.4,68.8,1014830,977464,37366,3.7
Nebraska,2014,784520,37787,14981,1.91,18.14,3953,8.257,3357,7.012,48175,2075,2134,10558,24854,61284,86138,10.98,3.168,47951,71157,23206,9.07,2.958,1431323,70.8,68.4,1012727,979728,32999,3.3
Nebraska,2015,800153,38088,15664,1.958,19.009,4147,8.549,3539,7.296,48813,2203,2241,11689,29721,61995,91716,11.462,3.714,53453,76052,22599,9.505,2.824,1440994,70.2,68.1,1011666,981326,30340,3
Nebraska,2016,815505,38557,14321,1.756,18.273,4171,8.482,3437,6.989,49544,2181,2244,12212,28342,60487,88829,10.893,3.475,52468,74508,22040,9.136,2.703,1452381,70,67.8,1016062,984966,31096,3.1
Nebraska,2017,825374,38809,9083,1.1,21.886,4138,8.327,3802,7.651,49861,2313,2363,16481,29145,70260,99405,12.044,3.531,58327,90322,31995,10.943,3.876,1473927,69.4,67.4,1023163,992740,30423,3
Nebraska,2018,836406,38743,12549,1.5,20.948,3853,7.74,4003,8.041,49707,2444,2497,13449,30276,69879,100155,11.974,3.62,57429,87606,30177,10.474,3.608,1484120,69.8,67.8,1036411,1006283,30128,2.9
Nebraska,2019,850038,38777,11678,1.374,19.114,3869,7.767,3676,7.38,49908,2414,2444,12077,29227,63691,92918,10.931,3.438,59575,81240,21665,9.557,2.549,1493995,70.3,68.1,1050380,1017743,32637,3.1
Nebraska,2020,861155,38732,9624,1.118,19.81,3997,8.011,4011,8.039,49890,2484,2557,13695,26560,68360,94920,11.022,3.084,57319,85296,27977,9.905,3.249,1501499,69.6,66.6,1045106,1000645,44461,4.3
Nebraska,2021,859367,39565,-13964,-1.625,21.321,4501,8.962,3837,7.64,50555,2283,2348,13561,29137,62477,91614,10.661,3.391,74872,105578,30706,12.286,3.573,1506711,69.2,67.4,1043331,1015997,27334,2.6
Nebraska,2022,872089,39812,38519,4.417,22.228,4505,8.888,4233,8.352,50821,2830,2891,14426,28227,107218,135445,15.531,3.237,66190,96926,30736,11.114,3.524,1514588,69.3,67.9,1050357,1027681,22676,2.2
Nevada,1978,265529,14655,46010,17.328,26.44,3496,21.965,2040,12.817,16644,1423,1436,10602,28102,53011,81113,30.548,10.583,18460,35103,16643,13.22,6.268,528750,70.7,67.5,373572,357075,16497,4.4
Nevada,1979,313870,15697,40391,12.869,30.467,3583,20.7,2339,13.513,17931,1678,1687,12326,33135,55069,88204,28.102,10.557,27075,47813,20738,15.233,6.607,567667,70.8,67.4,402171,382652,19519,4.9
Nevada,1980,338725,16334,9823,2.9,33.914,3387,18.466,2598,14.165,18736,1901,1927,11742,27919,39342,67261,19.857,8.242,37064,57438,20374,16.957,6.015,605167,71.3,66.8,431408,404162,27246,6.3
Nevada,1981,347769,16873,9402,2.704,36.883,3426,17.95,2675,14.015,19462,1980,2010,16482,32007,41528,73535,21.145,9.204,41681,64133,22452,18.441,6.456,633417,72.9,67.5,461648,427766,33882,7.3
Nevada,1982,352672,17004,2021,0.573,41.055,3293,16.777,2971,15.137,19789,2096,2110,14375,32516,41899,74415,21.1,9.22,46520,72394,25874,20.527,7.337,657667,73.4,66,482925,434375,48550,10.1
Nevada,1983,346965,17278,-16242,-4.681,34.765,3206,16.077,2928,14.683,20080,1979,2001,16200,27249,33062,60311,17.382,7.854,49892,76553,26661,22.064,7.684,671333,72.7,65.5,487731,439730,48001,9.8
Nevada,1984,356012,18404,33345,9.366,25.414,3685,17.802,2478,11.971,21303,1721,1736,9514,28256,50328,78584,22.073,7.937,28268,45239,16971,12.707,4.767,691583,72.3,66.8,500091,461800,38291,7.7
Nevada,1985,379974,18819,18194,4.788,31.528,3518,16.349,3087,14.346,21734,2165,2187,15418,26733,51360,78093,20.552,7.035,31364,59899,28535,15.764,7.51,721000,71.7,66.3,516828,478126,38702,7.5
Nevada,1986,398920,19310,15231,3.818,32.455,3790,17.168,3087,13.984,22427,2174,2203,14847,30350,49615,79965,20.045,7.608,36949,64734,27785,16.227,6.965,736750,72.3,67.7,532518,498789,33729,6.3
Nevada,1987,425953,20172,33240,7.804,32.459,4173,18.19,3152,13.739,23452,2119,2147,15769,38722,63647,102369,24.033,9.091,42184,69129,26945,16.229,6.326,764500,72.8,68.3,556441,521886,34555,6.2
Nevada,1988,457294,21080,22292,4.875,38.832,4295,17.842,3094,12.853,24673,2151,2174,17224,40110,70969,111079,24.291,8.771,51626,88787,37161,19.416,8.126,800000,72.5,68.7,579856,549615,30241,5.2
Nevada,1989,488339,22259,39526,8.094,31.714,4399,17.333,2999,11.816,26080,2075,2119,18318,39309,77652,116961,23.951,8.05,45592,77435,31843,15.857,6.521,840417,71.7,68.4,602938,574739,28199,4.7
Nevada,1990,528012,23367,40116,7.598,28.371,4458,16.667,3140,11.74,27406,2261,2287,18768,35869,79148,115017,21.783,6.793,48591,74901,26310,14.185,4.983,939455,71,67.6,666775,635524,31251,4.7
Nevada,1991,539154,24077,627,0.116,35.257,4571,16.333,3357,11.995,28593,2357,2396,19247,37302,58371,95673,17.745,6.919,66397,95046,28649,17.629,5.314,998374,70.1,66,700052,658822,41230,5.9
Nevada,1992,539427,24433,3278,0.608,32.712,4340,15.039,3739,12.957,29158,2468,2494,16816,36686,54820,91506,16.964,6.801,59994,88228,28234,16.356,5.234,1046898,69.6,64.9,728893,679191,49702,6.8
Nevada,1993,553128,25233,22795,4.121,28.436,4395,14.901,3726,12.632,29830,2387,2428,16560,35291,66148,101439,18.339,6.38,49109,78644,29535,14.218,5.34,1095255,70.1,65.2,767353,714408,52945,6.9
Nevada,1994,599786,26683,54185,9.034,26.568,5149,16.759,3431,11.167,31583,2388,2436,20835,45770,88092,133862,22.318,7.631,47900,79677,31777,13.284,5.298,1158696,70.1,65.7,811880,761150,50730,6.2
Nevada,1995,643668,28168,43347,6.734,25.212,5402,16.639,3615,11.135,33359,2600,2649,19135,50653,73836,124489,19.341,7.869,55050,81142,26092,12.606,4.054,1222720,69.4,65.5,848452,801122,47330,5.6
Nevada,1996,680381,29099,42196,6.202,29.692,5518,16.258,4055,11.947,34672,2838,2890,22882,62510,80696,143206,21.048,9.188,62724,101010,38286,14.846,5.627,1286411,69.5,66,894523,849225,45298,5.1
Nevada,1997,731468,30500,43123,5.895,30.927,6414,18.01,4571,12.835,36535,2992,3055,20436,61513,94722,156235,21.359,8.41,71934,113112,41178,15.464,5.63,1354018,69.9,66.8,945871,904551,41320,4.4
Nevada,1998,785701,32009,39805,5.066,28.833,6208,16.505,4324,11.496,38555,2868,2898,18643,61516,91558,153074,19.482,7.829,76121,113269,37148,14.416,4.728,1413959,69.2,66.3,978130,937223,40907,4.2
Nevada,1999,832508,33306,51394,6.173,29.604,6727,16.987,4663,11.775,40634,3083,3184,22458,71387,103236,174623,20.976,8.575,82268,123229,40961,14.802,4.92,1469316,69.7,66.9,1023530,982876,40654,4
Nevada,2000,889528,34300,57431,6.456,28.067,6530,15.79,5128,12.4,42056,3324,3388,22218,68837,113428,182265,20.49,7.739,80665,124834,44169,14.034,4.965,1522648,70.3,67.4,1070776,1026650,44126,4.1
Nevada,2001,928369,34966,18951,2.041,31.149,6534,15.377,5721,13.464,42898,3637,3731,26660,63083,100456,163539,17.616,6.795,94126,144588,50462,15.574,5.436,1579709,70.5,66.8,1113529,1055769,57760,5.2
Nevada,2002,938484,35605,-7221,-0.769,39.339,7060,16.194,5823,13.357,44215,3595,3664,27671,80883,103712,184595,19.669,8.618,130469,191816,61347,20.439,6.537,1634790,69.4,65.4,1134096,1069601,64495,5.7
Nevada,2003,954691,37124,35741,3.744,29.018,7392,16.411,5500,12.211,45989,3582,3628,23544,61106,113151,174257,18.253,6.401,93204,138516,45312,14.509,4.746,1690420,68.1,64.5,1150376,1089893,60483,5.3
Nevada,2004,999774,38772,52453,5.246,26.575,7585,16.151,5620,11.967,47945,3688,3792,27704,67728,117571,185299,18.534,6.774,80401,132846,52445,13.288,5.246,1756312,67.1,64.1,1178651,1126205,52446,4.4
Nevada,2005,1055399,40380,58800,5.571,27.117,7921,16.193,5708,11.669,50024,3862,3943,34952,72749,129147,201896,19.13,6.893,83605,143096,59491,13.558,5.637,1819152,67.5,64.7,1228449,1177587,50862,4.1
Nevada,2006,1126133,42549,76285,6.774,25.651,8918,17.304,5836,11.324,53079,4117,4169,26064,84182,136537,220719,19.6,7.475,99750,144434,44684,12.826,3.968,1883416,68.6,65.8,1291512,1239263,52249,4
Nevada,2007,1177927,43669,23186,1.968,33.779,8641,16.018,6899,12.789,54817,4640,4687,30785,82663,139471,222134,18.858,7.018,131641,198948,67307,16.89,5.714,1938289,69.4,66.2,1344209,1282414,61795,4.6
Nevada,2008,1172405,43299,-31852,-2.717,30.784,7643,13.951,7593,13.86,54808,5320,5428,34072,71109,109349,180458,15.392,6.065,149523,212310,62787,18.109,5.355,1976670,69.5,64.7,1373107,1278789,94318,6.9
Nevada,2009,1103413,41725,-116079,-10.52,24.729,6640,12.257,8333,15.382,53326,5637,5787,37627,55821,80613,136434,12.365,5.059,188657,252513,63856,22.885,5.787,1999624,68.4,60.4,1367367,1207052,160315,11.7
Nevada,2010,1024366,40706,-47265,-4.614,27.212,6558,12.407,7544,14.272,52365,4928,5029,32180,60510,78865,139375,13.606,5.907,132807,186640,53833,18.22,5.255,2061293,65.9,56.9,1358860,1171879,186981,13.8
Nevada,2011,1001391,40551,-4801,-0.479,26.414,6563,12.536,6618,12.641,52325,4418,4510,30727,42398,89858,132256,13.207,4.234,89761,137057,47296,13.687,4.723,2092674,65,56.4,1360791,1179653,181138,13.3
Nevada,2012,1008611,41008,19687,1.952,24.524,6518,12.387,6205,11.792,52776,3950,4103,28190,48159,95204,143363,14.214,4.775,76967,123676,46709,12.262,4.631,2122954,64.4,56.9,1366208,1207733,158475,11.6
Nevada,2013,1034270,41533,34151,3.302,24.853,6567,12.379,5861,11.048,53403,3859,3950,25985,58517,104155,162672,15.728,5.658,79252,128521,49269,12.426,4.764,2154637,63.6,57.3,1370727,1234021,136706,10
Nevada,2014,1071125,42583,34434,3.215,21.981,6990,12.919,5614,10.376,54794,3654,3692,21801,51190,100966,152156,14.205,4.779,73234,117722,44488,10.991,4.153,2192083,63,57.8,1380084,1267424,112660,8.2
Nevada,2015,1107206,43691,39361,3.555,22.935,7201,12.944,5614,10.091,56425,3711,3784,23492,67809,98523,166332,15.023,6.124,87103,126971,39868,11.468,3.601,2235028,62.5,58.2,1396761,1301094,95667,6.8
Nevada,2016,1146591,44809,30131,2.628,22.418,7215,12.603,5580,9.747,58065,3704,3796,28454,56980,101673,158653,13.837,4.97,82296,128522,46226,11.209,4.032,2279404,62,58.5,1414233,1332390,81843,5.8
Nevada,2017,1176017,45457,32257,2.743,23.534,6923,11.839,6118,10.462,58880,3892,3958,24650,54995,115644,170639,14.51,4.676,86131,138382,52251,11.767,4.443,2308537,62.6,59.4,1444262,1372022,72240,5
Nevada,2018,1206702,46671,26845,2.225,23.167,7293,12.258,6012,10.105,60138,3807,3895,23493,60329,106297,166626,13.808,4.999,93233,139781,46548,11.584,3.857,2357842,63.4,60.6,1494692,1429284,65408,4.4
Nevada,2019,1243612,47545,45032,3.621,20.737,7158,11.796,6050,9.97,61238,4167,4242,29011,55942,118034,173976,13.99,4.498,82581,128944,46363,10.369,3.728,2409356,64.1,61.5,1545118,1481046,64072,4.1
Nevada,2020,1269919,48424,9851,0.776,23.437,7342,11.87,6138,9.924,62455,3965,4034,26342,57520,101146,158666,12.494,4.529,93784,148815,55031,11.718,4.333,2456855,61.3,53,1505941,1302514,203427,13.5
Nevada,2021,1215519,50255,-121243,-9.975,24.158,8697,13.708,6721,10.593,64435,4151,4238,24273,57136,89684,146820,12.079,4.701,221189,268063,46874,22.053,3.856,2493657,60.2,56.1,1500442,1397961,102481,6.8
Nevada,2022,1220730,52652,126695,10.379,21.536,9426,14.34,6801,10.346,67045,4817,4928,25966,73900,184244,258144,21.147,6.054,85158,131449,46291,10.768,3.792,2527224,61.6,58.4,1557609,1476297,81312,5.2
New Hampshire,1978,278253,17603,31815,11.434,22.241,3059,16.03,1945,10.192,19640,1392,1422,6760,24401,38357,62758,22.554,8.769,19225,30943,11718,11.12,4.211,647833,67.2,64.6,435252,418634,16618,3.8
New Hampshire,1979,308465,18397,25790,8.361,22.32,2856,14.189,1985,9.862,20564,1441,1451,6943,17385,42830,60215,19.521,5.636,21795,34425,12630,11.16,4.094,667583,68,65.9,454226,439927,14299,3.1
New Hampshire,1980,325007,18487,5965,1.835,28.657,2482,12.019,2335,11.307,20724,1673,1686,9537,17566,34967,52533,16.164,5.405,30038,46568,16530,14.328,5.086,682833,68.4,65.4,467391,446355,21036,4.5
New Hampshire,1981,331537,18737,5120,1.544,28.137,2654,12.693,2261,10.813,21106,1659,1696,7746,19207,32556,51763,15.613,5.793,34759,46643,11884,14.069,3.585,697167,68.7,65.3,479184,454956,24228,5.1
New Hampshire,1982,339246,18753,9820,2.895,31.268,2637,12.464,2522,11.92,21215,1741,1760,9863,20419,42439,62858,18.529,6.019,33301,53038,19737,15.634,5.818,709500,68.7,63.9,487172,453628,33544,6.9
New Hampshire,1983,340472,19387,1141,0.335,31.433,2991,13.861,2243,10.394,21953,1526,1545,8704,20392,34259,54651,16.052,5.989,36822,53510,16688,15.716,4.901,721000,69.5,65.7,501143,473683,27460,5.5
New Hampshire,1984,363942,20971,42877,11.781,21.133,3697,16.209,2001,8.773,23656,1430,1456,7849,30741,50592,81333,22.348,8.447,25345,38456,13111,10.567,3.602,737583,70.8,67.8,522206,500362,21844,4.2
New Hampshire,1985,395273,22288,23599,5.97,29.24,3969,16.295,2562,10.519,25060,1870,1900,14919,26578,54810,81388,20.59,6.724,33902,57789,23887,14.62,6.043,757333,71.2,68.6,539248,519465,19783,3.7
New Hampshire,1986,416702,24026,18762,4.502,31.846,4779,18.333,2743,10.522,27086,2030,2052,12462,32961,52153,85114,20.426,7.91,40090,66352,26262,15.923,6.302,779250,71.8,69.9,559445,544635,14810,2.6
New Hampshire,1987,435922,25701,20638,4.734,31.688,5142,18.308,3143,11.19,29086,2263,2296,15944,35715,53991,89706,20.578,8.193,44071,69068,24997,15.844,5.734,803500,72.3,70.6,580600,567665,12935,2.2
New Hampshire,1988,458266,26839,19814,4.324,31.027,4894,16.421,3541,11.882,30479,2620,2642,15976,34224,56683,90907,19.837,7.468,44885,71093,26208,15.513,5.719,822583,72.1,70.4,593492,579431,14061,2.4
New Hampshire,1989,470807,27133,3007,0.639,31.641,4344,14.133,3861,12.562,30978,3000,3034,16988,29747,47744,77491,16.459,6.318,48309,74484,26175,15.821,5.56,837417,72.5,70.1,607297,586981,20316,3.3
New Hampshire,1990,462743,26181,-18533,-4.005,28.298,3638,11.902,4470,14.624,30151,3453,3508,19086,27019,38454,65473,14.149,5.839,55540,84006,28466,18.154,6.152,847908,73.5,69.6,622870,590148,32722,5.3
New Hampshire,1991,444307,24931,-33764,-7.599,25.018,3427,11.564,4355,14.695,29171,3151,3204,20289,24754,30825,55579,12.509,5.571,56096,89343,33247,20.108,7.483,848271,73.1,68.1,619776,577662,42114,6.8
New Hampshire,1992,420503,24642,3843,0.914,30.72,3421,11.756,3523,12.106,29050,2409,2452,12695,24504,43929,68433,16.274,5.827,42928,64590,21662,15.36,5.151,850003,72.7,67.4,618083,573023,45060,7.3
New Hampshire,1993,426982,24919,10158,2.379,26.529,3316,11.366,3061,10.492,29301,2066,2121,9570,21424,45370,66794,15.643,5.018,38802,56636,17834,13.264,4.177,857402,72.4,67.9,620355,582473,37882,6.1
New Hampshire,1994,444510,25507,19423,4.37,24.316,3584,12.072,2927,9.859,30017,1990,2018,10778,23515,49952,73467,16.528,5.29,35117,54044,18927,12.158,4.258,866717,72.2,69,626011,597844,28167,4.5
New Hampshire,1995,462526,26360,20388,4.408,23.203,3791,12.426,2784,9.125,31013,1946,2035,11767,27294,46754,74048,16.009,5.901,34500,53660,19160,11.602,4.142,879282,71.9,69.2,632401,608220,24181,3.8
New Hampshire,1996,471644,26925,14203,3.011,23.995,3755,11.999,2952,9.433,31697,2016,2090,11772,23151,47638,70789,15.009,4.909,37661,56586,18925,11.998,4.013,894598,71.1,68.5,636271,612396,23875,3.8
New Hampshire,1997,488316,27392,13581,2.781,26.292,3716,11.622,3184,9.958,32239,2076,2123,11380,24960,52816,77776,15.927,5.111,40932,64195,23263,13.146,4.764,908163,71.9,69.4,652663,630664,21999,3.4
New Hampshire,1998,510124,28026,21409,4.197,23.937,3475,10.662,2956,9.07,32851,1920,1959,11671,24546,57916,82462,16.165,4.812,40855,61053,20198,11.968,3.959,920645,71.9,69.9,661845,643128,18717,2.8
New Hampshire,1999,526304,28343,11451,2.176,23.542,3368,10.166,2849,8.599,33390,1950,2000,10883,24091,49311,73402,13.947,4.577,42739,61951,19212,11.771,3.65,935044,72.2,70.3,675423,656886,18537,2.7
New Hampshire,2000,546252,28487,24877,4.554,24.423,3316,9.887,3051,9.097,33672,1974,2037,12193,28211,63371,91582,16.766,5.164,43673,66705,23032,12.211,4.216,949844,72.2,70.3,685799,667603,18196,2.7
New Hampshire,2001,556707,28579,3927,0.705,26.265,3358,9.951,3203,9.492,33822,2065,2138,11343,27424,49613,77037,13.838,4.926,45780,73110,27330,13.133,4.909,965420,71.7,69.3,692029,668566,23463,3.4
New Hampshire,2002,556568,28454,-13980,-2.512,28.717,3572,10.521,3517,10.359,33979,2165,2219,15974,31296,48620,79916,14.359,5.623,64288,93896,29608,16.871,5.32,980304,71.5,68.2,700563,668980,31583,4.5
New Hampshire,2003,546124,28603,-6892,-1.262,27.473,3511,10.303,3301,9.686,34184,2174,2216,12710,25945,49072,75017,13.736,4.751,57982,81909,23927,14.998,4.381,993695,71.3,68.2,708938,677387,31551,4.5
New Hampshire,2004,547133,29124,8430,1.541,22.232,3691,10.697,3050,8.839,34827,2049,2098,11828,22369,46879,69248,12.657,4.088,40229,60818,20589,11.116,3.763,1007298,71,68.3,715495,688271,27224,3.8
New Hampshire,2005,552248,29410,2634,0.477,24.685,3692,10.527,3211,9.155,35313,2214,2236,13156,26440,44354,70794,12.819,4.788,47420,68160,20740,12.342,3.756,1019428,71.2,68.6,726101,699666,26435,3.6
New Hampshire,2006,564132,29635,19282,3.418,23.342,3925,11.035,3418,9.61,35821,2404,2439,11287,29066,56057,85123,15.089,5.152,44693,65841,21148,11.671,3.749,1032458,70.9,68.4,732384,706655,25729,3.5
New Hampshire,2007,573603,29473,-1478,-0.258,26.183,3627,10.124,3598,10.043,35841,2401,2417,12228,22802,52292,75094,13.092,3.975,54985,76572,21587,13.349,3.763,1042854,70.8,68.3,737928,712023,25905,3.5
New Hampshire,2008,581146,28985,16659,2.867,26.457,3236,9.084,3644,10.229,35421,2449,2485,11502,27270,66265,93535,16.095,4.692,53442,76876,23434,13.228,4.032,1051320,70.7,68,742881,715076,27805,3.7
New Hampshire,2009,579187,28040,-26963,-4.655,19.902,2781,7.947,3851,11.005,34458,2461,2505,12773,17433,40203,57636,9.951,3.01,63686,84599,20913,14.607,3.611,1057314,70,65.7,739802,694362,45440,6.1
New Hampshire,2010,564013,27763,-3781,-0.67,23.758,2957,8.617,3266,9.518,34161,2013,2061,10653,19783,47215,66998,11.879,3.508,51298,70779,19481,12.549,3.454,1055691,70,65.8,739340,694132,45208,6.1
New Hampshire,2011,559211,27407,-7930,-1.418,20.504,2824,8.302,3121,9.175,33867,2010,2038,9565,16507,40824,57331,10.252,2.952,46937,65261,18324,11.67,3.277,1060141,69.5,65.7,736785,696591,40194,5.5
New Hampshire,2012,551902,27517,-6376,-1.155,22.312,3098,9.122,2899,8.536,34062,1769,1818,10559,19058,42511,61569,11.156,3.453,40528,67945,27417,12.311,4.968,1068654,69.3,65.5,740796,700448,40348,5.4
New Hampshire,2013,549751,27433,2897,0.527,21.616,2893,8.488,2829,8.3,34117,1787,1803,8750,19263,43050,62313,11.335,3.504,40117,59416,19299,10.808,3.51,1075451,69.1,65.5,743036,704023,39013,5.3
New Hampshire,2014,556906,27368,13007,2.336,18.697,2916,8.52,2714,7.93,34325,1717,1757,8216,25334,39734,65068,11.684,4.549,35017,52061,17044,9.348,3.06,1083434,68.6,65.7,743756,711740,32016,4.3
New Hampshire,2015,570245,27367,14608,2.562,17.998,2860,8.312,2701,7.85,34487,1725,1753,8505,19158,46765,65923,11.56,3.36,37001,51315,14314,8.999,2.51,1089562,68.5,66.2,746317,720832,25485,3.4
New Hampshire,2016,586183,27743,16648,2.84,16.903,3067,8.817,2463,7.08,35089,1673,1698,7982,18951,47239,66190,11.292,3.233,35375,49542,14167,8.452,2.417,1097720,68.5,66.6,752478,731002,21476,2.9
New Hampshire,2017,598403,27616,9524,1.592,20.19,2715,7.745,2783,7.939,35020,1710,1742,9603,20581,49352,69933,11.687,3.439,41969,60409,18440,10.095,3.082,1112624,68.1,66.2,758133,736918,21215,2.8
New Hampshire,2018,608158,27717,9957,1.637,20.425,2812,8.02,2697,7.692,35121,1771,1785,9999,24878,47186,72064,11.85,4.091,43583,62107,18524,10.212,3.046,1120839,68.7,66.9,770469,750285,20184,2.6
New Hampshire,2019,616818,27950,7027,1.139,17.906,2892,8.197,2558,7.25,35450,1773,1780,8678,18278,43972,62250,10.092,2.963,39166,55223,16057,8.953,2.603,1129954,68.9,67.1,778467,758463,20004,2.6
New Hampshire,2020,621709,27886,-489,-0.079,18.897,2747,7.757,2837,8.011,35367,1895,1935,10517,16015,42726,58741,9.448,2.576,40826,59230,18404,9.527,2.96,1138430,66.9,62.4,761429,710538,50891,6.7
New Hampshire,2021,603714,27906,-34211,-5.667,19.07,3120,8.832,3196,9.047,35288,1918,1996,11900,18849,38715,57564,9.535,3.122,70650,91775,21125,15.202,3.499,1147916,65.6,63.4,753206,727574,25632,3.4
New Hampshire,2022,600225,28499,28262,4.709,20.273,3557,10.007,3036,8.541,35806,2010,2083,10875,21258,67847,89105,14.845,3.542,40818,60843,20025,10.137,3.336,1159883,65.6,64.1,760333,742975,17358,2.3
New Jersey,1978,2367578,129503,121436,5.129,28.216,19047,13.102,15231,10.477,147285,10240,10332,66064,138199,317260,455459,19.237,5.837,193446,334023,140577,14.108,5.938,5497917,62.9,58.4,3460776,3210049,250727,7.2
New Jersey,1979,2497851,134190,136731,5.474,25.357,18927,12.614,14148,9.429,152435,9641,9688,47721,133742,319680,453422,18.152,5.354,213165,316691,103526,12.679,4.145,5553917,64.1,59.7,3561012,3316808,244204,6.9
New Jersey,1980,2580883,136361,17015,0.659,28.804,17788,11.568,15338,9.975,154991,11033,11093,55094,123680,265028,388708,15.061,4.792,264462,371693,107231,14.402,4.155,5599167,64.1,59.5,3586628,3330524,256104,7.1
New Jersey,1981,2600095,137048,44827,1.724,28.175,17679,11.364,16390,10.536,156210,11707,11843,56175,138409,272711,411120,15.812,5.323,252763,366293,113530,14.088,4.366,5662250,63.8,59,3611992,3339638,272354,7.5
New Jersey,1982,2616870,136848,-2406,-0.092,30.607,17374,11.112,17059,10.91,156518,12211,12313,64216,123272,277206,400478,15.304,4.711,280803,402884,122081,15.396,4.665,5714250,63.6,58.1,3636895,3319882,317013,8.7
New Jersey,1983,2630972,140317,26414,1.004,31.658,19447,12.279,15895,10.037,160147,11025,11117,58862,143475,299400,442875,16.833,5.453,277562,416461,138899,15.829,5.279,5779000,63.9,58.7,3695196,3392740,302456,8.2
New Jersey,1984,2722137,145087,169850,6.24,25.559,20705,12.708,15280,9.379,165635,10878,10985,57058,161565,356157,517722,19.019,5.935,231402,347872,116470,12.779,4.279,5834250,65.2,61.1,3804285,3566154,238131,6.3
New Jersey,1985,2875960,149101,108597,3.776,29.588,22265,13.257,17606,10.483,170279,12750,12972,93170,163793,370276,534069,18.57,5.695,269609,425472,155863,14.794,5.42,5869250,65.3,61.6,3832477,3617038,215439,5.6
New Jersey,1986,2953000,153572,59689,2.021,31.117,23239,13.452,18161,10.513,175290,12974,13125,75382,172971,346162,519133,17.58,5.857,317516,459444,141928,15.559,4.806,5947750,65.5,62.3,3898668,3702846,195822,5
New Jersey,1987,3055066,158329,121047,3.962,33.178,25403,14.254,19438,10.907,181202,13813,13955,87740,238391,389465,627856,20.551,7.803,330271,506809,176538,16.589,5.779,6002000,65.9,63.2,3953640,3793826,159814,4
New Jersey,1988,3157829,162799,39239,1.243,32.9,25577,13.879,19981,10.842,187085,14395,14556,86138,206096,352599,558695,17.692,6.527,351227,519456,168229,16.45,5.327,6031333,65.8,63.4,3971203,3821755,149448,3.8
New Jersey,1989,3217088,164974,65419,2.033,31.341,24161,12.807,21152,11.212,190161,15345,15572,89595,202353,367204,569557,17.704,6.29,339027,504138,165111,15.671,5.132,6032500,66.2,63.5,3995539,3833386,162153,4.1
New Jersey,1990,3252401,165003,7466,0.23,31.355,22862,11.982,21574,11.307,191450,15782,15963,90814,194759,322599,517358,15.907,5.988,350844,509892,159048,15.677,4.89,6045543,67.2,63.8,4060426,3854684,205742,5.1
New Jersey,1991,3159079,160728,-161682,-5.118,28.016,21291,11.221,24268,12.79,188253,16871,17136,108748,164539,277991,442530,14.008,5.208,414318,604212,189894,19.126,6.011,6075964,66.9,62.3,4063472,3787556,275916,6.8
New Jersey,1992,3056092,158992,-39860,-1.304,30.067,19827,10.594,21696,11.593,186218,14318,14486,80230,139714,319729,459443,15.034,4.572,338451,499303,160852,16.338,5.263,6097353,66.6,60.9,4058434,3713445,344989,8.5
New Jersey,1993,3047480,161592,40727,1.336,29.961,21052,11.242,18861,10.072,188365,12687,12955,69420,154276,342985,497261,16.317,5.062,309358,456534,147176,14.981,4.829,6128492,65.7,60.6,4026183,3713811,312372,7.8
New Jersey,1994,3085313,163372,17917,0.581,29.041,21508,11.339,19324,10.188,190772,13175,13421,75035,156707,309218,465925,15.101,5.079,297223,448008,150785,14.521,4.887,6158214,66.1,61.5,4067789,3790023,277766,6.8
New Jersey,1995,3132264,167737,89637,2.862,26.102,23353,12.087,18437,9.543,195665,12931,13192,77581,172324,326111,498435,15.913,5.502,267032,408798,141766,13.051,4.526,6196853,66.4,62.1,4115289,3851225,264064,6.4
New Jersey,1996,3153440,169085,25249,0.801,29.978,22760,11.597,20066,10.224,197610,14095,14318,80469,178697,319219,497916,15.79,5.667,317128,472667,155539,14.989,4.932,6247242,67,62.9,4183875,3927350,256525,6.1
New Jersey,1997,3215032,171586,74522,2.318,32.15,24473,12.308,22060,11.095,200038,14561,14939,98358,203022,388324,591346,18.393,6.315,307880,516824,208944,16.075,6.499,6301880,67.4,63.8,4248548,4022818,225730,5.3
New Jersey,1998,3348338,174706,107928,3.223,28.968,23291,11.509,19858,9.813,204088,13058,13260,75006,193032,399863,592895,17.707,5.765,324462,484967,160505,14.484,4.794,6352436,66.7,63.6,4234802,4040639,194163,4.6
New Jersey,1999,3420404,175456,49916,1.459,29.003,22125,10.811,21002,10.263,205208,13637,13940,88988,189034,356887,545921,15.961,5.527,328106,496005,167899,14.501,4.909,6398991,66.9,64,4283139,4094543,188596,4.4
New Jersey,2000,3499996,175871,94725,2.706,28.332,22134,10.744,20659,10.028,206748,13388,13671,81154,184456,406072,590528,16.872,5.27,316877,495803,178926,14.166,5.112,6440442,66.6,64.1,4287640,4130824,156816,3.7
New Jersey,2001,3575235,176724,57399,1.605,29.96,22618,10.896,21003,10.118,208397,13472,13763,82132,199996,392979,592975,16.586,5.594,352042,535576,183534,14.98,5.133,6488919,66.2,63.4,4294366,4112095,182271,4.2
New Jersey,2002,3596708,176341,-41246,-1.147,33.737,24201,11.57,23658,11.31,209447,14535,14801,99587,219351,387351,606702,16.868,6.099,438531,647948,209417,18.015,5.822,6535944,66.5,62.6,4345273,4094389,250884,5.8
New Jersey,2003,3571901,177001,-10274,-0.288,31.351,23505,11.202,22683,10.811,210232,14732,14942,94055,181796,378109,559905,15.675,5.09,377528,570179,192651,15.963,5.394,6573502,66.1,62.2,4344387,4091465,252922,5.8
New Jersey,2004,3592914,179473,28682,0.798,29.614,23983,11.363,22481,10.652,211807,14350,14514,83979,176042,384647,560689,15.605,4.9,330415,532007,201592,14.807,5.611,6602607,65.9,62.6,4348048,4134064,213984,4.9
New Jersey,2005,3597622,181272,-31020,-0.862,28.159,24768,11.631,22615,10.62,214017,15056,15243,89447,182780,323750,506530,14.08,5.081,342393,537550,195157,14.942,5.425,6630669,66.2,63.2,4387304,4192396,194908,4.4
New Jersey,2006,3623512,183957,76759,2.118,26.871,26710,12.355,22331,10.329,218384,15725,15872,79668,209948,353654,563602,15.554,5.794,322159,486843,164684,13.436,4.545,6658162,66.6,63.6,4436646,4231848,204798,4.6
New Jersey,2007,3651644,183395,-21662,-0.593,29.265,24639,11.288,24830,11.375,218184,16481,16604,84057,179481,354852,534333,14.633,4.915,367292,555995,188703,15.226,5.168,6686077,66.3,63.5,4436092,4248982,187110,4.2
New Jersey,2008,3612360,180087,-48030,-1.33,27.731,21624,9.982,24572,11.343,215161,16917,17106,94430,170571,330308,500879,13.866,4.722,358267,548909,190642,15.195,5.277,6722056,66.9,63.2,4495936,4251455,244481,5.4
New Jersey,2009,3508420,173589,-182526,-5.203,22.497,19257,9.066,26348,12.405,208852,17515,17780,92484,142857,251785,394642,11.248,4.072,414647,577168,162521,16.451,4.632,6766177,67.1,61.1,4540303,4133366,406937,9
New Jersey,2010,3388362,170276,-67078,-1.98,23.333,19533,9.438,23476,11.343,204992,14747,14938,79898,138526,256770,395296,11.666,4.088,304279,462374,158095,13.646,4.666,6860979,66.5,60,4559778,4118982,440796,9.7
New Jersey,2011,3364490,169116,16862,0.501,24.117,20367,9.958,21314,10.421,204052,13905,14087,66933,126731,295839,422570,12.56,3.767,270473,405708,135235,12.059,4.019,6916237,66,59.8,4561786,4134708,427078,9.4
New Jersey,2012,3403547,170948,52890,1.554,23.861,21618,10.549,19809,9.666,205830,12620,12833,66323,137625,321325,458950,13.484,4.044,270912,406060,135148,11.93,3.971,6947898,65.9,59.7,4576286,4147221,429065,9.4
New Jersey,2013,3447747,171196,38658,1.121,24.537,20851,10.113,20110,9.753,206553,13093,13295,73960,138645,323008,461653,13.39,4.021,279361,422995,143634,12.269,4.166,6973700,64.9,59.5,4528019,4147661,380358,8.4
New Jersey,2014,3490975,171160,29260,0.838,23.458,20790,10.047,20083,9.705,207283,13228,13403,69484,147904,290804,438708,12.567,4.237,279366,409448,130082,11.729,3.726,6994770,64.2,59.9,4493894,4191318,302576,6.7
New Jersey,2015,3520545,170548,49646,1.41,23.986,20228,9.76,20261,9.776,207238,13409,13608,84456,164349,307510,471859,13.403,4.668,277818,422213,144395,11.993,4.101,7012397,64.1,60.4,4494606,4237876,256730,5.7
New Jersey,2016,3585150,171822,73699,2.056,22.436,21320,10.225,18797,9.015,209780,12931,13066,73209,149872,326012,475884,13.274,4.18,267135,402185,135050,11.218,3.767,7030113,63.9,60.8,4492821,4271201,221620,4.9
New Jersey,2017,3636132,171584,61805,1.7,24.692,20535,9.783,20243,9.644,210055,13166,13369,73453,171871,338859,510730,14.046,4.727,303900,448925,145025,12.346,3.988,7269751,63.5,60.6,4614953,4406151,208802,4.5
New Jersey,2018,3699506,171572,46584,1.259,23.235,19392,9.241,19689,9.382,209706,12997,13099,65499,147583,328798,476381,12.877,3.989,295120,429797,134677,11.618,3.64,7311915,63,60.5,4604787,4420713,184074,4
New Jersey,2019,3757397,172530,65778,1.751,20.871,20488,9.732,18877,8.966,211334,13202,13367,72854,142331,315548,457879,12.186,3.788,262268,392101,129833,10.435,3.455,7351409,63.8,61.6,4687390,4525044,162346,3.5
New Jersey,2020,3794210,171224,8605,0.227,23.355,20005,9.481,20645,9.784,210687,13597,13854,75413,160112,291562,451674,11.904,4.22,294717,443069,148352,11.678,3.91,7378545,62.9,56.9,4638386,4200980,437406,9.4
New Jersey,2021,3686036,168455,-252312,-6.845,21.625,21425,10.257,25025,11.981,207080,14896,15363,78676,145332,253218,398550,10.812,3.943,487930,650862,162932,17.658,4.42,7390254,62.9,58.7,4648814,4337793,311021,6.7
New Jersey,2022,3685499,173689,245112,6.651,20.482,25207,12.034,20348,9.714,211903,14331,14705,75282,162269,460278,622547,16.892,4.403,237764,377435,139671,10.241,3.79,7401874,64,61.5,4736213,4552563,183650,3.9
New Mexico,1978,294586,22378,33253,11.288,33.05,4855,19.268,3393,13.466,25928,2451,2470,15275,29427,52506,81933,27.813,9.989,25804,48680,22876,16.525,7.765,866417,61.3,57.5,531179,498329,32850,6.2
New Mexico,1979,325316,23047,22872,7.031,32.315,4305,16.324,3559,13.495,26745,2504,2533,12996,27595,47840,75435,23.188,8.483,31275,52563,21288,16.158,6.544,895583,61.6,57.5,551377,514623,36754,6.7
New Mexico,1980,335534,23241,-1608,-0.479,37.583,4019,14.952,3765,14.007,27006,2668,2689,14281,25770,37282,63052,18.792,7.68,41525,64660,23135,19.271,6.895,921583,61.2,56.5,563793,520963,42830,7.6
New Mexico,1981,337595,23481,8676,2.57,36.239,4083,15.023,3689,13.573,27376,2672,2695,13255,27641,42206,69847,20.69,8.188,39593,61171,21578,18.12,6.392,944250,61.2,56.8,578071,536354,41717,7.2
New Mexico,1982,346831,23597,8682,2.503,36.34,4121,14.956,3786,13.741,27721,2661,2690,13618,26568,45133,71701,20.673,7.66,40839,63019,22180,18.17,6.395,968000,61.7,56.1,597293,543522,53771,9
New Mexico,1983,348007,24575,-6957,-1.999,38.624,4529,16.045,3549,12.573,28717,2421,2454,14076,27995,39212,67207,19.312,8.044,49884,74164,24280,21.311,6.977,992417,61.8,55.8,613598,553947,59651,9.7
New Mexico,1984,355585,25779,21141,5.945,32.52,4848,16.514,3632,12.372,29965,2580,2615,13193,31682,47278,78960,22.206,8.91,37490,57819,20329,16.26,5.717,1011417,62.1,57.3,627672,579213,48459,7.7
New Mexico,1985,375312,26071,18013,4.799,34.714,4588,15.226,4266,14.158,30293,2994,3028,17209,29240,53915,83155,22.156,7.791,35710,65142,29432,17.357,7.842,1027667,63.3,57.8,650229,594344,55885,8.6
New Mexico,1986,383808,26355,-1050,-0.274,38.702,4774,15.609,4182,13.674,30880,2971,3012,16422,32865,41405,74270,19.351,8.563,49801,75320,25519,19.624,6.649,1055833,63.3,57.5,668735,607095,61640,9.2
New Mexico,1987,387600,26387,7316,1.888,39.567,4547,14.687,4395,14.196,31036,2976,3031,16752,36721,47276,83997,21.671,9.474,47327,76681,29354,19.784,7.573,1072917,63,57.4,676055,615737,60318,8.9
New Mexico,1988,394719,26553,5110,1.295,37.912,4565,14.611,4218,13.5,31418,2912,2965,18590,32013,47919,79932,20.25,8.11,44559,74822,30263,18.956,7.667,1083750,63,58.3,683190,631398,51792,7.6
New Mexico,1989,401170,26874,8150,2.032,33.891,4525,14.279,4027,12.708,31938,2818,2883,16207,29515,46615,76130,18.977,7.357,41419,67980,26561,16.945,6.621,1095500,63.3,59.1,693917,647093,46824,6.7
New Mexico,1990,413341,27470,15465,3.741,29.553,4427,13.716,3779,11.708,32601,2634,2688,14948,29353,47189,76542,18.518,7.101,38052,61077,23025,14.776,5.57,1118366,63.6,59.4,711313,663786,47527,6.7
New Mexico,1991,424490,27711,6384,1.504,34.868,4566,13.89,3926,11.943,33192,2703,2774,17721,33684,46705,80389,18.938,7.935,45101,74005,28904,17.434,6.809,1139093,63.4,58.9,722652,670375,52277,7.2
New Mexico,1992,433452,27934,9901,2.284,33.974,4308,12.902,3915,11.725,33587,2514,2585,14202,31611,51920,83531,19.271,7.293,47603,73630,26027,16.987,6.005,1164473,63.3,58.7,737279,683148,54131,7.3
New Mexico,1993,446980,28890,18973,4.245,29.088,4310,12.679,3467,10.199,34416,2303,2346,11971,26412,57569,83981,18.789,5.909,42054,65008,22954,14.544,5.135,1191937,63.5,58.9,756564,701624,54940,7.3
New Mexico,1994,470367,29803,20572,4.374,28.787,4721,13.481,3618,10.332,35570,2522,2560,13968,30604,57670,88274,18.767,6.506,44058,67702,23644,14.393,5.027,1224400,63.6,59.4,778886,727893,50993,6.5
New Mexico,1995,490498,30613,23582,4.808,26.762,4764,13.212,3766,10.444,36557,2662,2717,15233,33348,55867,89215,18.189,6.799,40976,65633,24657,13.381,5.027,1254280,63.5,59.3,796740,743735,53005,6.7
New Mexico,1996,500512,30994,12949,2.587,30.768,4675,12.707,3895,10.587,37181,2694,2736,15580,32550,57397,89947,17.971,6.503,49004,76998,27994,15.384,5.593,1281327,63.4,58.7,813001,751904,61097,7.5
New Mexico,1997,511883,31100,6297,1.23,35.144,4904,13.114,4459,11.924,37618,2953,2997,19145,38510,57734,96244,18.802,7.523,58031,89947,31916,17.572,6.235,1299541,63.2,59.1,820665,767900,52765,6.4
New Mexico,1998,533801,31488,9479,1.776,30.726,4513,11.886,4112,10.829,38171,2684,2765,14979,36236,55252,91488,17.139,6.788,51698,82009,30311,15.363,5.678,1316837,63.4,59.4,834613,782512,52101,6.2
New Mexico,1999,540620,31357,-691,-0.128,31.992,4429,11.566,4220,11.02,38398,2782,2843,15990,33514,52964,86478,15.996,6.199,58348,87169,28821,16.124,5.331,1330634,62.9,59.3,836491,789414,47077,5.6
New Mexico,2000,547352,31186,9002,1.645,29.746,4267,11.107,4271,11.117,38416,2823,2892,15727,31029,59382,90411,16.518,5.669,52441,81409,28968,14.873,5.292,1342045,63,59.9,846150,803666,42484,5
New Mexico,2001,552492,31148,2096,0.379,32.824,4391,11.436,4362,11.361,38410,2583,2652,14527,32548,60224,92772,16.792,5.891,57633,90676,33043,16.412,5.981,1353307,63.2,60,855088,812557,42531,5
New Mexico,2002,555018,31286,-3285,-0.592,35.488,4664,12.083,4507,11.676,38678,2590,2649,17184,40381,58102,98483,17.744,7.276,66977,101768,34791,18.336,6.268,1372721,63.1,59.7,866850,819275,47575,5.5
New Mexico,2003,562641,31721,18277,3.248,28.83,4447,11.431,3974,10.215,39139,2387,2440,13658,36953,62429,99382,17.663,6.568,50096,81105,31009,14.415,5.511,1392399,63.2,59.5,880251,828390,51861,5.9
New Mexico,2004,577185,32271,10686,1.851,28.23,4433,11.24,3828,9.706,39741,2437,2468,12848,31413,60744,92157,15.967,5.442,51689,81471,29782,14.115,5.16,1413287,63,59.5,890462,841002,49460,5.6
New Mexico,2005,590025,32773,16710,2.832,28.048,4558,11.358,3770,9.394,40524,2440,2494,15186,34272,65183,99455,16.856,5.809,57579,82745,25166,14.024,4.265,1436753,63.1,59.8,906007,858722,47285,5.2
New Mexico,2006,615699,33554,35212,5.719,25.241,5172,12.586,4041,9.833,41660,2699,2735,15161,41174,71741,112915,18.339,6.687,50037,77703,27666,12.62,4.493,1461711,62.6,59.9,914467,876100,38367,4.2
New Mexico,2007,631851,33959,876,0.139,31.019,4869,11.588,4094,9.744,42404,2675,2718,15241,33615,65259,98874,15.648,5.32,67925,97998,30073,15.51,4.76,1482766,62.1,59.9,920673,887565,33108,3.6
New Mexico,2008,638934,33724,-1201,-0.188,30.403,4363,10.316,4534,10.721,42206,2893,2955,16731,35120,62006,97126,15.201,5.497,65036,98327,33291,15.389,5.21,1499299,62.3,59.6,933628,893645,39983,4.3
New Mexico,2009,626114,32855,-27575,-4.404,23.435,3686,8.797,4628,11.045,41431,3052,3093,15810,25706,47658,73364,11.717,4.106,74191,100939,26748,16.122,4.272,1516254,61.2,56.9,928373,862687,65686,7.1
New Mexico,2010,604311,31981,-16308,-2.699,22.631,3513,8.572,4418,10.781,40528,2825,2873,13479,22043,46337,68380,11.315,3.648,61120,84688,23568,14.014,3.9,1560087,59.5,54.9,928862,856602,72260,7.8
New Mexico,2011,594845,31656,-807,-0.136,23.635,3786,9.362,3926,9.708,40372,2570,2642,11739,21557,48738,70295,11.817,3.624,51948,71102,19154,11.953,3.22,1583448,58.4,54.2,925108,858165,66943,7.2
New Mexico,2012,593607,31635,-1973,-0.332,25.444,3753,9.3,3759,9.315,40351,2316,2422,10998,24738,50780,75518,12.722,4.167,53202,77491,24289,13.054,4.092,1593231,58.3,54.2,928762,863937,64825,7
New Mexico,2013,592845,31483,479,0.081,26.713,3610,8.965,3713,9.221,40217,2351,2389,13377,28641,51020,79661,13.437,4.831,53324,79182,25858,13.356,4.362,1600998,58.1,54,929410,865207,64203,6.9
New Mexico,2014,604449,31311,21909,3.625,21.876,3517,8.744,3515,8.739,40224,2303,2330,10942,40174,47850,88024,14.563,6.646,45564,66115,20551,10.938,3.4,1605079,58.1,54.2,931950,870570,61380,6.6
New Mexico,2015,620934,31171,12176,1.961,21.141,3679,9.129,3525,8.746,40379,2219,2240,10749,27736,50077,77813,12.532,4.467,45930,65637,19707,10.571,3.174,1610774,58.3,54.4,938300,876206,62094,6.6
New Mexico,2016,629117,31043,3553,0.565,22.865,3556,8.797,3464,8.569,40471,2220,2295,12160,26618,48860,75478,11.997,4.231,50194,71925,21731,11.433,3.454,1617770,58.4,54.4,944245,880515,63730,6.7
New Mexico,2017,627765,30954,-2360,-0.376,24.298,3400,8.419,3570,8.84,40301,2171,2224,11076,24525,51741,76266,12.149,3.907,53283,78626,25343,12.525,4.037,1627137,58.3,54.8,948581,890988,57593,6.1
New Mexico,2018,628321,30896,3804,0.605,22.369,3348,8.33,3539,8.805,40096,2152,2189,10636,24810,49268,74078,11.79,3.949,47803,70274,22471,11.184,3.576,1634623,57.8,55,944936,898360,46576,4.9
New Mexico,2019,633349,31051,4903,0.774,21.604,3511,8.73,3259,8.103,40345,2223,2249,11259,24575,48743,73318,11.576,3.88,49452,68415,18963,10.802,2.994,1645584,58.1,55.2,955798,908397,47401,5
New Mexico,2020,649294,30800,6128,0.944,21.954,3521,8.737,3617,8.976,40250,2304,2394,12195,27549,49851,77400,11.921,4.243,48566,71272,22706,10.977,3.497,1662073,56,51.6,931499,858100,73399,7.9
New Mexico,2021,628826,30475,-46632,-7.416,19.558,3765,9.401,4149,10.36,39858,2383,2475,11736,22237,39256,61493,9.779,3.536,80393,108125,27732,17.195,4.41,1670662,56.4,52.4,942420,875911,66509,7.1
New Mexico,2022,621777,31079,32654,5.252,22.006,4344,10.825,3778,9.415,40411,2488,2537,12467,28564,72505,101069,16.255,4.594,42457,68415,25958,11.003,4.175,1676040,56.5,54.2,947411,908878,38533,4.1
New York,1978,5532953,313583,199527,3.606,28.778,43259,12.257,40084,11.357,354527,28689,29019,148759,292808,702863,995671,17.995,5.292,481747,796144,314397,14.389,5.682,13252750,59.2,54.6,7846338,7241276,605062,7.7
New York,1979,5800647,318453,260811,4.496,24.937,41560,11.621,36983,10.341,359923,26797,27077,127676,276367,707689,984056,16.965,4.764,475192,723245,248053,12.468,4.276,13278917,60.2,55.9,7995630,7428750,566880,7.1
New York,1980,5925145,319081,43148,0.728,27.8,39434,10.941,38811,10.768,360724,28692,28930,146220,261504,605238,866742,14.628,4.413,563064,823594,260530,13.9,4.397,13312917,59.9,55.5,7976617,7384324,592293,7.4
New York,1981,5982680,319670,70654,1.181,28.814,40235,11.13,38318,10.599,362475,28525,28854,149825,297958,634635,932593,15.588,4.98,603224,861939,258715,14.407,4.324,13390583,59.8,55.3,8009607,7402631,606976,7.6
New York,1982,5962177,316872,-25728,-0.432,29.12,39189,10.842,41270,11.417,360425,30539,30808,166769,274159,593919,868078,14.56,4.598,603738,893806,290068,14.991,4.865,13464250,59.4,54.2,7997094,7302599,694495,8.7
New York,1983,5947716,323835,-16316,-0.274,31.823,45181,12.412,37990,10.437,367599,27870,28206,177612,319452,626912,946364,15.911,5.371,650269,962680,312411,16.186,5.253,13547417,59.5,54.2,8059904,7344657,715247,8.9
New York,1984,6066412,330677,240739,3.968,25.524,45789,12.328,38420,10.344,375095,28516,28784,150955,324446,690487,1014933,16.73,5.348,517085,774194,257109,12.762,4.238,13629000,59.4,55.1,8101645,7516040,585605,7.2
New York,1985,6324374,336649,214237,3.387,27.997,48870,12.916,42202,11.154,381699,31899,32380,198590,354542,745026,1099568,17.386,5.606,552183,885331,333148,13.999,5.268,13682667,60.7,56.6,8298702,7748628,550074,6.6
New York,1986,6487395,342477,160811,2.479,28.909,49751,12.915,42495,11.031,388852,31458,31841,180478,371914,726618,1098532,16.933,5.733,610478,937721,327243,14.455,5.044,13717250,61.4,57.6,8426495,7903976,522519,6.2
New York,1987,6693688,346964,231724,3.462,30.422,52204,13.316,45703,11.658,395293,34019,34324,204044,474167,775737,1249904,18.673,7.084,664357,1018180,353823,15.211,5.286,13765500,61.6,58.7,8484910,8076350,408560,4.8
New York,1988,6842672,352576,55036,0.804,32.595,52832,13.225,45403,11.365,403208,33707,34089,196864,386657,783568,1170225,17.102,5.651,756370,1115189,358819,16.298,5.244,13802667,61.9,59.3,8547450,8186055,361395,4.2
New York,1989,6909244,356842,81829,1.184,30.092,52547,12.932,46544,11.455,409330,34571,35172,206930,393914,727486,1121400,16.23,5.701,671858,1039571,367713,15.046,5.322,13805167,62.9,59.8,8679562,8257658,421904,4.9
New York,1990,6974159,356328,29663,0.425,28.97,49143,11.975,47192,11.5,411350,35830,36330,202967,355302,684571,1039873,14.91,5.095,671750,1010210,338460,14.485,4.853,14078827,62.7,59.4,8831430,8361916,469514,5.3
New York,1991,6832614,349489,-334721,-4.899,26.684,47319,11.556,50326,12.291,407963,37309,37912,251185,367869,543739,911608,13.342,5.384,860243,1246329,386086,18.241,5.651,14099913,62,57.5,8745483,8106964,638519,7.3
New York,1992,6602873,343859,-117572,-1.781,28.413,43205,10.674,48847,12.067,401964,34262,34713,194050,310776,627269,938045,14.207,4.707,680855,1055617,374762,15.987,5.676,14116134,62,56.6,8751942,7991253,760689,8.7
New York,1993,6497661,344745,-36051,-0.555,29.185,44580,11.086,44178,10.986,402322,31259,31855,173906,322192,625970,948162,14.592,4.959,658472,984213,325741,15.147,5.013,14157688,61.7,56.8,8732081,8039606,692475,7.9
New York,1994,6531631,345094,57057,0.874,28.326,45130,11.188,43852,10.872,404001,31381,31944,177104,336818,645302,982120,15.036,5.157,608285,925063,316778,14.163,4.85,14176908,61.3,57,8687721,8085906,601815,6.9
New York,1995,6585742,349786,71678,1.088,27.257,47237,11.613,41507,10.204,409632,29947,30525,165407,340272,628932,969204,14.717,5.167,618066,897526,279460,13.628,4.243,14194879,61.1,57.2,8668388,8118546,549842,6.3
New York,1996,6582363,350831,23620,0.359,28.288,46569,11.366,43586,10.638,411199,31593,32278,189382,347533,607086,954619,14.503,5.28,613478,930999,317521,14.144,4.824,14236266,61.8,57.9,8792042,8243078,548964,6.2
New York,1997,6684900,354157,108349,1.621,29.634,49243,11.92,45757,11.076,414860,32351,33003,195570,370586,728267,1098853,16.438,5.544,614144,990504,376360,14.817,5.63,14294487,63.1,59.1,9026109,8447934,578175,6.4
New York,1998,6863564,360210,146597,2.136,28.621,46398,11.071,40242,9.602,422178,27122,27558,147918,351637,777177,1128814,16.446,5.123,672007,982217,310210,14.311,4.52,14384124,63.1,59.6,9074633,8566015,508618,5.6
New York,1999,6987316,362026,89026,1.274,27.237,45009,10.615,41400,9.764,425828,28019,28515,164361,337504,703092,1040596,14.893,4.83,625984,951570,325586,13.619,4.66,14473178,63,59.7,9115114,8642778,472336,5.2
New York,2000,7167539,364443,217668,3.037,25.454,45454,10.616,41133,9.606,430342,27294,27906,161205,364617,765276,1129893,15.764,5.087,586040,912225,326185,12.727,4.551,14547332,62.8,60,9140541,8727537,413004,4.5
New York,2001,7252401,366696,5771,0.08,28.472,46081,10.681,43044,9.977,432938,27479,28071,172470,361647,676559,1038206,14.315,4.987,659183,1032435,373252,14.236,5.147,14642218,62.3,59.3,9126538,8680547,445991,4.9
New York,2002,7260820,367122,-174321,-2.401,32.427,50901,11.702,49567,11.396,435631,29931,30505,223529,491940,685299,1177239,16.214,6.775,847398,1351560,504162,18.614,6.944,14735313,63.1,59.2,9294770,8718237,576533,6.2
New York,2003,7213025,372122,98326,1.363,27.88,49803,11.372,44933,10.26,440378,30316,30805,167675,347118,756690,1103808,15.303,4.812,669142,1005482,336340,13.94,4.663,14828504,62.6,58.6,9283810,8689954,593856,6.4
New York,2004,7328700,377190,56202,0.767,27.499,51948,11.717,46127,10.404,446282,31185,31625,174886,353053,710803,1063856,14.516,4.817,673908,1007654,333746,13.749,4.554,14920093,62.7,59.1,9359930,8816050,543880,5.8
New York,2005,7350323,381736,-22357,-0.304,27.232,50911,11.367,47853,10.684,449424,32012,32414,179798,368941,631871,1000812,13.616,5.019,681493,1023169,341676,13.92,4.648,15008243,63,59.9,9455488,8986176,469312,5
New York,2006,7420210,385514,139939,1.886,25.018,54417,12.017,47604,10.512,456245,34614,34992,183991,380699,687420,1068119,14.395,5.131,619468,928180,308712,12.509,4.16,15100241,63,60.2,9520386,9090969,429417,4.5
New York,2007,7481119,386825,-9523,-0.127,28.387,51928,11.348,49025,10.713,459065,33501,33808,182325,361689,700127,1061816,14.193,4.835,692887,1071339,378452,14.321,5.059,15191922,62.6,59.8,9511023,9088287,422736,4.4
New York,2008,7504982,387056,74626,0.994,25.545,48773,10.612,47445,10.323,460273,32927,33267,172243,340264,692935,1033199,13.767,4.534,644871,958573,313702,12.772,4.18,15272352,63.1,59.7,9641100,9121271,519829,5.4
New York,2009,7425783,383575,-263882,-3.554,22.315,46050,10.019,50697,11.03,457315,34262,34656,186693,297342,531179,828521,11.157,4.004,774457,1092403,317946,14.711,4.282,15354331,62.9,57.7,9664010,8853905,810105,8.4
New York,2010,7263619,384428,-69956,-0.963,23.782,48105,10.504,47192,10.305,458417,31600,32045,160939,313816,549912,863728,11.891,4.32,633846,933684,299838,12.854,4.128,15382860,62.6,57.1,9630297,8790607,839690,8.7
New York,2011,7285600,386601,109473,1.503,22.843,49711,10.807,46539,10.117,461591,31235,31627,148633,304740,636854,941594,12.924,4.183,548739,832121,283382,11.421,3.89,15474264,61.6,56.5,9537752,8741662,796090,8.3
New York,2012,7417845,392601,163732,2.207,21.761,50788,10.928,44377,9.549,467945,30106,30560,147012,291294,679536,970830,13.088,3.927,539464,807098,267634,10.88,3.608,15564711,61.7,56.4,9602599,8775083,827516,8.6
New York,2013,7569949,395386,124739,1.648,22.55,49156,10.477,46398,9.889,470571,30925,31391,163323,311869,666363,978232,12.923,4.12,565194,853493,288299,11.275,3.808,15639250,61.6,56.8,9632949,8880792,752157,7.8
New York,2014,7724238,397777,168851,2.186,21.993,49713,10.523,46053,9.748,474269,31789,32120,163279,356203,662025,1018228,13.182,4.611,561617,849377,287760,10.996,3.725,15690912,60.7,56.9,9523567,8925328,598239,6.3
New York,2015,7882304,399567,146659,1.861,22.436,49308,10.368,46786,9.838,476838,32140,32614,164555,348786,682095,1030881,13.078,4.425,591505,884222,292717,11.218,3.714,15718035,60.7,57.5,9536519,9035989,500530,5.2
New York,2016,8035432,403805,160444,1.997,21.399,51423,10.713,45059,9.387,483185,32529,32924,192030,324553,695627,1020180,12.696,4.039,549961,859736,309775,10.699,3.855,15729054,60.6,57.6,9527021,9062866,464155,4.9
New York,2017,8163272,404230,90521,1.109,24.193,48530,10.034,47616,9.845,484115,32809,33234,188873,334343,743665,1078008,13.206,4.096,627130,987487,360357,12.097,4.414,16176117,60.8,58,9838170,9382750,455420,4.6
New York,2018,8268061,404451,102438,1.239,22.614,47203,9.757,47523,9.823,483621,32933,33325,181323,319136,718154,1037290,12.546,3.86,619877,934852,314975,11.307,3.81,16217662,60.6,58.1,9826126,9424212,401914,4.1
New York,2019,8388166,405630,168593,2.01,20.689,47711,9.838,45051,9.289,486308,33087,33478,180222,326565,709721,1036286,12.354,3.893,577778,867693,289915,10.344,3.456,16238937,60.7,58.3,9850900,9470443,380457,3.9
New York,2020,8488053,398413,-7321,-0.086,22.975,45893,9.507,53077,10.995,479144,35073,35545,183422,303857,671226,975083,11.488,3.58,653550,982404,328854,11.574,3.874,16196813,59.1,53.3,9564414,8628006,936408,9.8
New York,2021,8109552,386664,-753246,-9.288,20.171,48585,10.282,61736,13.065,465968,37730,38528,195598,314377,503520,817897,10.086,3.877,1196280,1571143,374863,19.374,4.622,16041437,59.4,55.2,9532961,8856999,675962,7.1
New York,2022,8002500,399172,542607,6.78,20.713,58352,12.372,46831,9.929,477403,34028,34731,170256,354999,1016393,1371392,17.137,4.436,521142,828785,307643,10.357,3.844,15937027,60.2,57.6,9595770,9178585,417185,4.3
North Carolina,1978,1811199,88788,133678,7.381,21.998,15576,14.802,11232,10.674,107403,7754,7822,34957,103399,229491,332890,18.38,5.709,128029,199212,71183,10.999,3.93,4113167,67.2,64.1,2763559,2637518,126041,4.6
North Carolina,1979,1947001,92325,107646,5.529,21.653,14755,13.446,10626,9.683,111803,7702,7790,40701,102606,215834,318440,16.355,5.27,141451,210794,69343,10.827,3.562,4197500,66.9,63.7,2809510,2673939,135571,4.8
North Carolina,1980,1997790,92878,11467,0.574,25.616,13491,12.007,12438,11.07,112886,8993,9107,43372,89669,177673,267342,13.382,4.488,178599,255875,77276,12.808,3.868,4292917,66.5,62.3,2855525,2673169,182356,6.4
North Carolina,1981,2009118,93144,13029,0.648,25.995,13637,12.037,12720,11.228,113751,9050,9167,43153,103570,170596,274166,13.646,5.155,178754,261137,82383,12.998,4.1,4367500,66.4,62.2,2901656,2715573,186083,6.4
North Carolina,1982,2005735,92046,-25266,-1.26,26.275,13341,11.74,13703,12.059,113454,9724,9859,44789,94325,169175,263500,13.137,4.703,204617,288766,84149,14.397,4.195,4435750,66.3,60.2,2942038,2669735,272303,9.3
North Carolina,1983,1989990,95023,13533,0.68,27.623,15435,13.405,12162,10.563,116779,8675,8817,42400,105374,183011,288385,14.492,5.295,189907,274852,84945,13.812,4.269,4489750,65.8,60,2955085,2692189,262896,8.9
North Carolina,1984,2082185,101684,166319,7.988,20.357,19968,16.576,12703,10.545,124098,9760,9832,50451,121378,256879,378257,18.166,5.829,130995,211938,80943,10.179,3.887,4571667,66.3,62,3031815,2832167,199648,6.6
North Carolina,1985,2205889,105334,83296,3.776,25.627,17554,13.914,13427,10.643,128225,9635,9810,58360,119773,246178,365951,16.59,5.43,183888,282655,98767,12.814,4.477,4668167,66.6,62.9,3111146,2934953,176193,5.7
North Carolina,1986,2284392,109091,71326,3.122,26.181,18794,14.379,13702,10.484,133246,9590,9764,54237,132589,237771,370360,16.213,5.804,198499,299034,100535,13.09,4.401,4730750,67.4,63.8,3186254,3017601,168653,5.3
North Carolina,1987,2375277,111828,95653,4.027,28.208,19420,14.319,14714,10.849,137979,10194,10313,59803,161863,268798,430661,18.131,6.814,206546,335008,128462,14.104,5.408,4805583,68.1,65,3272640,3124223,148417,4.5
North Carolina,1988,2491368,115408,114032,4.577,27.197,19966,14.19,14917,10.601,143233,10067,10261,59282,180449,272370,452819,18.176,7.243,222443,338787,116344,13.598,4.67,4875250,68.3,65.8,3330300,3206724,123576,3.7
North Carolina,1989,2586472,118631,71908,2.78,27.052,19246,13.247,15294,10.527,147266,10319,10564,60973,158056,263696,421752,16.306,6.111,228260,349844,121584,13.526,4.701,4937750,68.7,66.2,3391363,3270297,121066,3.6
North Carolina,1990,2664919,121637,79483,2.983,25.616,18997,12.727,15018,10.061,151253,10668,10937,63337,149470,271342,420812,15.791,5.609,228096,341329,113233,12.808,4.249,5096212,68.3,65.5,3478905,3336193,142712,4.1
North Carolina,1991,2649638,120544,-96811,-3.654,26.527,17981,11.873,17217,11.369,151825,12035,12344,82537,147298,204137,351435,13.264,5.559,302879,448246,145367,16.917,5.486,5192678,68.1,64.1,3538567,3329498,209069,5.9
North Carolina,1992,2620673,120896,41198,1.572,27.241,16858,11.078,15966,10.492,152621,10365,10577,56002,133638,264512,398150,15.193,5.099,232515,356952,124437,13.621,4.748,5271773,68.4,64.1,3603488,3377858,225630,6.3
North Carolina,1993,2676748,123501,73848,2.759,24.857,16981,11.032,14334,9.312,155247,9553,9769,57473,122252,284277,406529,15.187,4.567,225141,332681,107540,12.429,4.018,5377368,67.4,63.9,3622825,3437974,184851,5.1
North Carolina,1994,2783446,127046,108383,3.894,23.163,18409,11.679,14187,9.001,159735,9769,10006,58411,143720,287031,430751,15.475,5.163,216794,322368,105574,11.582,3.793,5485713,67.1,64.1,3679610,3516760,162850,4.4
North Carolina,1995,2898141,131496,126662,4.37,22.172,19436,11.963,13895,8.552,165243,9707,9975,56836,147273,300670,447943,15.456,5.082,218407,321281,102874,11.086,3.55,5602058,67,64.1,3753054,3589633,163421,4.4
North Carolina,1996,2979251,134456,75341,2.529,25.477,20025,11.993,15309,9.169,169329,10390,10646,61031,173788,281069,454857,15.267,5.833,257814,379516,121702,12.739,4.085,5720236,67.8,64.9,3880825,3711509,169316,4.4
North Carolina,1997,3071709,138432,105609,3.438,27.365,22978,13.326,16774,9.728,175536,10976,11272,72569,190247,335654,525901,17.121,6.194,269346,420292,150946,13.683,4.914,5831164,68,65.4,3962734,3810687,152047,3.8
North Carolina,1998,3199288,141560,82459,2.577,26.581,21454,12.036,17118,9.603,180423,11155,11420,67913,183215,324453,507668,15.868,5.727,268886,425209,156323,13.291,4.886,5941176,66.9,64.5,3972102,3831500,140602,3.5
North Carolina,1999,3281252,143858,69598,2.121,28.839,20813,11.477,18961,10.456,182272,11395,11797,72473,191449,351296,542745,16.541,5.835,297874,473147,175273,14.42,5.342,6040021,67,64.8,4046225,3912963,133262,3.3
North Carolina,2000,3363239,144589,73403,2.183,26.56,19711,10.755,17981,9.811,184146,11808,12164,72217,172446,347596,520042,15.463,5.127,289238,446639,157401,13.28,4.68,6114876,67.5,65,4127465,3972811,154654,3.7
North Carolina,2001,3418511,145528,39616,1.159,30.01,20755,11.229,19245,10.412,185582,11852,12369,77165,193245,359319,552564,16.164,5.653,333790,512948,179158,15.005,5.241,6202734,67.6,63.8,4191959,3956124,235835,5.6
North Carolina,2002,3390132,145754,-120702,-3.56,30.09,21774,11.667,20707,11.095,187167,12292,12658,91536,211932,298113,510045,15.045,6.251,426764,630747,203983,18.605,6.017,6286161,67,62.3,4209274,3917218,292056,6.9
North Carolina,2003,3338435,147015,16913,0.507,29.992,21002,11.173,19300,10.267,188824,11858,12074,69210,183487,334051,517538,15.502,5.496,332514,500625,168111,14.996,5.036,6363376,67.3,62.8,4285401,3997950,287451,6.7
North Carolina,2004,3355825,150198,24575,0.732,28.006,21507,11.28,17876,9.376,192479,11373,11624,73303,165433,329050,494483,14.735,4.93,312264,469908,157644,14.003,4.698,6452249,66.5,62.6,4287954,4036223,251731,5.9
North Carolina,2005,3387141,153396,34014,1.004,27.917,22583,11.615,18681,9.608,196379,12101,12399,73564,188898,317917,506815,14.963,5.577,323541,472801,149260,13.959,4.407,6571000,66.2,62.5,4348830,4105112,243718,5.6
North Carolina,2006,3469049,157100,115842,3.339,25.795,25366,12.711,18983,9.512,202754,12821,13041,71107,214364,348896,563260,16.237,6.179,293773,447418,153645,12.897,4.429,6721862,66.4,63,4461103,4232804,228299,5.1
North Carolina,2007,3545247,159690,28594,0.807,29.402,24822,12.113,20602,10.053,207036,13000,13276,77538,194371,355407,549778,15.507,5.483,352917,521184,168267,14.701,4.746,6879821,65.8,62.5,4528594,4297692,230902,5.1
North Carolina,2008,3551538,158774,-4319,-0.122,28.229,21592,10.433,21484,10.381,207018,14294,14554,81255,169642,331634,501276,14.114,4.777,340742,505595,164853,14.236,4.642,7011929,65.3,61.3,4578477,4296605,281872,6.2
North Carolina,2009,3443761,152622,-229252,-6.657,21.461,18216,8.905,24621,12.036,201360,16109,16425,88934,146058,223474,369532,10.73,4.241,429460,598784,169324,17.388,4.917,7117828,64.8,57.7,4613198,4104074,509124,11
North Carolina,2010,3271694,150254,-101195,-3.093,23.488,19371,9.674,21716,10.845,199066,13252,13612,70493,147148,237082,384230,11.744,4.498,335145,485425,150280,14.837,4.593,7295065,63.5,56.7,4633695,4135783,497912,10.7
North Carolina,2011,3244711,148791,53021,1.634,22.963,19018,9.583,20259,10.208,197834,12814,13200,66197,134579,290990,425569,13.116,4.148,254543,372548,118005,11.482,3.637,7416868,62.8,56.4,4657873,4180071,477802,10.3
North Carolina,2012,3298888,149467,67682,2.052,22.779,19441,9.803,18421,9.289,198823,11160,11419,62759,129782,313627,443409,13.441,3.934,252842,375727,122885,11.39,3.725,7504450,62.9,56.9,4720203,4271383,448820,9.5
North Carolina,2013,3360393,149573,63057,1.876,22.509,18931,9.504,18078,9.076,199617,11323,11488,59331,145008,296251,441259,13.131,4.315,252889,378202,125313,11.255,3.729,7595424,61.9,57.1,4701391,4336379,365012,7.8
North Carolina,2014,3418983,149992,52181,1.526,21.482,18832,9.408,17762,8.873,200710,11130,11373,58774,129333,290083,419416,12.267,3.783,236208,367235,131027,10.741,3.832,7688413,61.1,57.4,4698287,4410647,287640,6.1
North Carolina,2015,3501014,151848,113176,3.233,19.968,19549,9.675,16839,8.333,203422,10352,10523,60791,152617,310092,462709,13.216,4.359,232394,349533,117139,9.984,3.346,7792799,61.1,57.7,4763821,4493882,269939,5.7
North Carolina,2016,3614580,154937,110864,3.067,20.185,20671,10.043,15881,7.716,208219,10344,10551,68349,152696,322963,475659,13.159,4.224,253167,364795,111628,10.092,3.088,7911794,61.2,58.1,4844851,4598456,246395,5.1
North Carolina,2017,3712391,157487,82745,2.229,22.037,20888,9.946,17337,8.255,211783,10645,10933,63852,157121,334670,491791,13.247,4.232,269407,409046,139639,11.018,3.761,7932255,61.3,58.6,4865900,4646212,219688,4.5
North Carolina,2018,3814035,159911,73273,1.921,21.997,20321,9.545,18012,8.46,214055,11077,11418,69938,156999,335765,492764,12.92,4.116,275915,419491,143576,10.999,3.764,8032424,61.2,58.7,4911884,4715616,196268,4
North Carolina,2019,3896571,162286,90115,2.313,20.51,20277,9.4,16980,7.872,217353,11247,11409,65573,150289,339425,489714,12.568,3.857,257831,399599,141768,10.255,3.638,8128596,61.5,59.1,5000820,4807598,193222,3.9
North Carolina,2020,3961402,163760,30286,0.765,21.495,20696,9.481,18793,8.609,219249,11768,12107,68626,152330,303717,456047,11.512,3.845,292209,425761,133552,10.748,3.371,8200761,58.9,54.7,4831154,4483551,347603,7.2
North Carolina,2021,3947627,168107,-61002,-1.545,24.954,24506,11.066,20141,9.095,223633,11944,12301,63035,168745,323794,492539,12.477,4.275,407593,553541,145948,14.022,3.697,8308703,59.4,56.5,4939281,4697757,241524,4.9
North Carolina,2022,4016160,172754,197587,4.92,22.269,26060,11.517,20682,9.141,228956,14295,14616,71589,198247,446515,644762,16.054,4.936,300426,447175,146749,11.134,3.654,8433679,61.1,58.9,5155937,4965568,190369,3.7
North Dakota,1978,151427,13339,14147,9.342,25.088,2074,13.94,1519,10.209,15156,1092,1100,5073,10561,22581,33142,21.887,6.974,11449,18995,7546,12.544,4.983,458750,64.3,61.7,295165,282869,12296,4.2
North Dakota,1979,166205,13995,12899,7.761,26.555,2219,14.291,1552,9.995,15861,1111,1115,5626,13693,21274,34967,21.039,8.239,13722,22068,8346,13.278,5.022,463500,64.9,62.2,300603,288126,12477,4.2
North Dakota,1980,174315,14105,3251,1.865,31.328,1956,12.251,1769,11.08,16059,1308,1315,5639,11164,19392,30556,17.529,6.405,18604,27305,8701,15.664,4.992,467083,65,61.8,303520,288743,14777,4.9
North Dakota,1981,176074,14216,784,0.445,31.003,1905,11.789,1670,10.334,16277,1237,1249,5512,11547,16531,28078,15.947,6.558,19713,27294,7581,15.501,4.306,473000,65.5,62.2,309628,294380,15248,4.9
North Dakota,1982,178092,14130,2698,1.515,31.223,1921,11.787,1921,11.787,16297,1385,1399,6318,10486,20015,30501,17.127,5.888,18650,27803,9153,15.612,5.139,479250,65.5,61.8,313918,296392,17526,5.6
North Dakota,1983,177678,14315,-3510,-1.975,31.254,1960,11.961,1778,10.85,16478,1266,1288,6471,11328,16438,27766,15.627,6.376,21099,31276,10177,17.603,5.728,486917,65.5,61.7,318972,300196,18776,5.9
North Dakota,1984,178954,14856,5744,3.21,28.001,2227,13.27,1625,9.683,17083,1181,1191,5493,12360,18438,30798,17.21,6.907,16047,25054,9007,14,5.033,489250,66.2,62.7,323885,306566,17319,5.3
North Dakota,1985,182296,14591,508,0.279,30.649,1828,10.784,2097,12.371,16817,1521,1550,7628,9956,18488,28444,15.603,5.461,17257,27936,10679,15.325,5.858,486583,67.7,64,329378,311348,18030,5.5
North Dakota,1986,181752,14469,-2072,-1.14,29.558,1795,10.689,1842,10.969,16770,1327,1356,6293,10665,16196,26861,14.779,5.868,19739,28933,9194,15.919,5.059,486500,68.1,64.4,331531,313077,18454,5.6
North Dakota,1987,180896,14475,105,0.058,31.708,1917,11.424,1863,11.102,16808,1265,1280,6283,11382,17402,28784,15.912,6.292,18265,28679,10414,15.854,5.757,483583,68.4,65,330886,314468,16418,5
North Dakota,1988,184368,14671,5534,3.002,26.792,1884,11.126,1709,10.092,17021,1119,1133,5001,11829,18403,30232,16.398,6.416,15524,24698,9174,13.396,4.976,481583,68.7,65.5,330710,315500,15210,4.6
North Dakota,1989,188987,14727,3545,1.876,26.371,1735,10.152,1606,9.398,17154,1165,1173,5025,10922,17542,28464,15.061,5.779,16022,24919,8897,13.186,4.708,477417,69,66,329439,315331,14108,4.3
North Dakota,1990,193882,14755,5881,3.033,22.657,1651,9.606,1601,9.315,17213,1185,1198,5090,8352,19493,27845,14.362,4.308,14098,21964,7866,11.329,4.057,463434,68.4,65.5,316790,303752,13038,4.1
North Dakota,1991,198310,14635,3762,1.897,27.116,1757,10.196,1663,9.651,17279,1160,1185,5882,11939,18710,30649,15.455,6.02,17918,26887,8969,13.558,4.523,463999,68.2,65.2,316428,302697,13731,4.3
North Dakota,1992,204594,14612,6974,3.409,23.751,1674,9.672,1612,9.314,17339,1068,1079,4475,10047,21224,31271,15.284,4.911,16945,24297,7352,11.876,3.593,466195,68,64.9,317227,302709,14518,4.6
North Dakota,1993,210918,14870,6953,3.297,22.731,1677,9.598,1406,8.047,17607,959,971,4383,9164,21761,30925,14.662,4.345,16281,23972,7691,11.366,3.646,470059,68.4,65.5,321732,308008,13724,4.3
North Dakota,1994,218895,15134,7096,3.242,22.441,1664,9.361,1373,7.724,17921,986,1003,4427,10044,21613,31657,14.462,4.589,17256,24561,7305,11.22,3.337,474256,71.3,68.7,338299,325829,12470,3.7
North Dakota,1995,226068,15382,9226,4.081,22.441,1655,9.167,1384,7.666,18190,971,983,5137,11071,23521,34592,15.302,4.897,16152,25366,9214,11.221,4.076,478537,71.3,69,341334,330053,11281,3.3
North Dakota,1996,230438,15444,3297,1.431,24.984,1626,8.934,1474,8.098,18277,1014,1035,5048,10149,21934,32083,13.923,4.404,20122,28786,8664,12.492,3.76,483401,71.8,69.6,347224,336291,10933,3.1
North Dakota,1997,236773,15312,8744,3.693,25.838,1640,9.007,1774,9.742,18142,1204,1234,7647,12618,26715,39333,16.612,5.329,18700,30589,11889,12.919,5.021,485764,71.8,69.7,349015,338733,10282,2.9
North Dakota,1998,247767,15450,8237,3.325,23.918,1646,9.019,1543,8.455,18302,1033,1065,5528,12606,25262,37868,15.284,5.088,19300,29631,10331,11.959,4.17,486378,71.4,69.3,347088,336822,10266,3
North Dakota,1999,252272,15384,-1159,-0.459,25.304,1484,8.101,1472,8.036,18324,1006,1025,5542,11730,20187,31917,12.652,4.65,22548,33076,10528,13.111,4.173,485659,70.6,68.3,342722,331927,10795,3.1
North Dakota,2000,254056,15256,4238,1.668,22.438,1399,7.653,1528,8.359,18216,1101,1132,6062,9493,23248,32741,12.887,3.737,19494,28503,9009,11.219,3.546,485026,70.7,68.6,342761,332615,10146,3
North Dakota,2001,256436,15182,1856,0.724,23.908,1519,8.332,1541,8.452,18221,1028,1046,6304,12234,20276,32510,12.678,4.771,21095,30654,9559,11.954,3.728,484467,70.7,68.7,342528,332805,9723,2.8
North Dakota,2002,257056,15042,-3884,-1.511,28.444,1658,9.079,1678,9.189,18251,1020,1039,7140,16171,20387,36558,14.222,6.291,26997,40442,13445,15.733,5.23,484701,70.7,68.3,342463,330852,11611,3.4
North Dakota,2003,257898,15107,6186,2.399,22.682,1496,8.191,1448,7.928,18288,887,892,4950,9798,25636,35434,13.74,3.799,19608,29248,9640,11.341,3.738,485632,71.5,69,347099,335092,12007,3.5
North Dakota,2004,264188,15382,6491,2.457,20.549,1645,8.925,1346,7.303,18581,880,886,4676,10503,23132,33635,12.731,3.976,16893,27144,10251,10.275,3.88,489446,72.3,69.8,353652,341694,11958,3.4
North Dakota,2005,269959,15542,4915,1.821,22.286,1717,9.184,1458,7.799,18825,973,984,4703,10828,24168,34996,12.963,4.011,19336,30081,10745,11.143,3.98,491659,72.5,70.1,356385,344595,11790,3.3
North Dakota,2006,277430,15652,9461,3.41,21.585,1977,10.42,1678,8.844,19122,1131,1144,5213,13778,25625,39403,14.203,4.966,20057,29942,9885,10.793,3.563,493900,73.4,71.2,362712,351410,11302,3.1
North Dakota,2007,286405,15801,8942,3.122,24.669,1890,9.823,1595,8.289,19389,974,1000,5586,15305,28963,44268,15.456,5.344,25707,35326,9619,12.334,3.359,495854,74.1,71.9,367564,356434,11130,3
North Dakota,2008,298484,15867,16578,5.554,22.222,1685,8.672,1576,8.111,19484,1005,1022,6603,21188,28555,49743,16.665,7.099,23640,33165,9525,11.111,3.191,498983,74.5,72.2,371843,360446,11397,3.1
North Dakota,2009,296111,15870,-4616,-1.559,22.229,1537,7.878,1577,8.083,19489,1007,1020,5601,9205,23706,32911,11.114,3.109,27573,37527,9954,12.673,3.362,503717,73.5,70.6,370364,355736,14628,3.9
North Dakota,2010,294992,16069,2742,0.93,21.38,1621,8.266,1375,7.011,19734,837,848,3583,9772,24505,34277,11.62,3.313,23385,31535,8150,10.69,2.763,521042,72.8,70.1,379062,365041,14021,3.7
North Dakota,2011,304062,16341,11207,3.686,20.81,1942,9.73,1492,7.476,20183,942,958,4657,12780,30064,42844,14.091,4.203,23734,31637,7903,10.405,2.599,533220,72.6,70.2,387383,374434,12949,3.3
North Dakota,2012,321579,17009,23512,7.311,19.971,2281,11.088,1495,7.268,20964,974,990,5655,16495,39129,55624,17.297,5.129,22342,32112,9770,9.986,3.038,544583,72.6,70.5,395490,383888,11602,2.9
North Dakota,2013,338282,17366,10657,3.15,24.597,2255,10.621,1705,8.03,21507,1129,1132,7161,18258,34002,52260,15.449,5.397,26358,41603,15245,12.298,4.507,558633,71.9,69.8,401518,389928,11590,2.9
North Dakota,2014,351488,17736,15992,4.55,21.427,2289,10.497,1707,7.828,22098,1168,1176,5616,18598,35050,53648,15.263,5.291,26381,37656,11275,10.713,3.208,570413,71.8,69.9,409503,398783,10720,2.6
North Dakota,2015,362238,17979,5540,1.529,22.688,2246,10.062,1819,8.149,22536,1253,1275,6825,17795,28838,46633,12.874,4.913,30497,41093,10596,11.344,2.925,580163,70.8,68.8,410764,399296,11468,2.8
North Dakota,2016,356426,17767,-18475,-5.183,19.368,1909,8.475,1930,8.568,22515,1341,1365,6726,12742,21775,34517,9.684,3.575,41951,52992,11041,14.868,3.098,581106,70.9,68.7,411778,399001,12777,3.1
North Dakota,2017,343958,17548,-5631,-1.637,24.411,1835,8.192,2064,9.214,22285,1298,1317,6788,13505,28476,41981,12.205,3.926,33059,47612,14553,13.842,4.231,587828,70.7,68.9,415765,404901,10864,2.6
North Dakota,2018,343116,17453,3763,1.097,22.769,1758,7.907,1846,8.303,22190,1165,1217,6498,12029,30796,42825,12.481,3.506,26835,39062,12227,11.385,3.564,589972,69.8,68.2,412069,402201,9868,2.4
North Dakota,2019,348772,17567,6691,1.918,17.61,1831,8.208,1597,7.159,22424,1076,1101,5883,11913,25487,37400,10.723,3.416,21896,30709,8813,8.805,2.527,592785,69.9,68.3,414120,405150,8970,2.2
North Dakota,2020,353424,17539,1936,0.548,20.756,1802,8.038,1802,8.038,22419,1141,1158,5941,12784,25831,38615,10.926,3.617,25666,36679,11013,10.378,3.116,594041,68.9,65.5,409175,388962,20213,4.9
North Dakota,2021,343950,17634,-20905,-6.078,17.571,1946,8.657,1815,8.074,22544,1161,1197,7032,10355,19863,30218,8.786,3.011,38926,51123,12197,14.864,3.546,594634,68.5,66.5,407443,395160,12283,3
North Dakota,2022,337534,17702,8734,2.588,22.178,2046,9.061,1963,8.693,22622,1303,1377,7342,11415,34748,46163,13.677,3.382,25356,37429,12073,11.089,3.577,597168,69,67.6,412237,403886,8351,2
Ohio,1978,3540740,155707,200879,5.673,24.173,23872,12.498,18754,9.818,193569,12245,12442,63525,170799,458027,628826,17.76,4.824,275837,427947,152110,12.086,4.296,7891000,62.8,59.3,4953330,4680003,273327,5.5
Ohio,1979,3734138,159849,159011,4.258,22.903,22715,11.567,18068,9.2,198705,12058,12284,64534,174301,412317,586618,15.71,4.668,290155,427607,137452,11.451,3.681,7948500,63.6,59.9,5058507,4761077,297430,5.9
Ohio,1980,3776792,159880,-77888,-2.062,25.327,20224,10.161,19720,9.907,199296,13615,13803,68271,151600,326667,478267,12.663,4.014,412893,556155,143262,14.726,3.793,7994000,63.4,58.2,5070041,4648849,421192,8.3
Ohio,1981,3683155,159073,-103414,-2.808,23.986,20425,10.254,20336,10.209,199244,13983,14256,68608,164016,277706,441722,11.993,4.453,400823,545136,144313,14.801,3.918,8033667,63.7,57.5,5114048,4623199,490849,9.6
Ohio,1982,3566895,156316,-114422,-3.208,25.252,19933,10.059,22230,11.218,197021,15036,15284,78499,150241,300113,450354,12.626,4.212,413252,564776,151524,15.834,4.248,8045417,63.7,55.7,5121163,4477347,643816,12.6
Ohio,1983,3448632,158010,-65479,-1.899,28.324,21711,10.984,20165,10.202,198434,13084,13403,71608,178844,309547,488391,14.162,5.186,401559,553870,152311,16.061,4.417,8032750,63.6,55.8,5110741,4479711,631030,12.3
Ohio,1984,3494661,163226,191773,5.488,22.483,23573,11.718,18284,9.089,203815,12396,12648,65356,176102,408519,584621,16.729,5.039,260364,392848,132484,11.241,3.791,8040083,63.5,57.5,5108972,4625810,483162,9.5
Ohio,1985,3632358,164247,105064,2.892,25.509,22525,11.032,21770,10.662,204560,15023,15409,99710,160711,407645,568356,15.647,4.424,278139,463292,185153,12.755,5.097,8074083,63.7,58,5140859,4681446,459413,8.9
Ohio,1986,3732900,166950,100817,2.701,26.123,24328,11.771,19970,9.663,208854,13733,13993,85845,197133,391257,588390,15.762,5.281,335980,487573,151593,13.062,4.061,8102083,64.4,59.1,5220947,4787676,433271,8.3
Ohio,1987,3866654,169782,95083,2.459,29.514,26224,12.41,21264,10.063,213798,14044,14306,95805,243517,422167,665684,17.216,6.298,354135,570601,216466,14.757,5.598,8162917,64.5,59.9,5265206,4891781,373425,7.1
Ohio,1988,3953371,173321,109478,2.769,28.579,25978,11.997,21140,9.762,218964,13875,14351,107559,257406,416988,674394,17.059,6.511,364491,564916,200425,14.289,5.07,8230667,64.7,60.8,5323989,5003175,320814,6
Ohio,1989,4096835,176366,143965,3.514,26.54,25560,11.55,21177,9.57,223484,14196,14737,98145,251982,435635,687617,16.784,6.151,341740,543652,201912,13.27,4.928,8261167,65.5,61.8,5408179,5106358,301821,5.6
Ohio,1990,4216936,178139,76299,1.809,25.13,24044,10.68,20791,9.235,226755,14604,14968,96750,209842,396316,606158,14.374,4.976,367002,529859,162857,12.565,3.862,8231273,65.7,61.9,5407455,5095359,312096,5.8
Ohio,1991,4210094,177459,-144736,-3.438,25.505,23833,10.48,22032,9.688,228311,15092,15411,130967,200170,336719,536889,12.752,4.755,464729,681625,216896,16.19,5.152,8297527,65.3,61,5416042,5063110,352932,6.5
Ohio,1992,4128223,177159,-5828,-0.141,28.013,22250,9.752,22012,9.647,228289,13893,14283,104213,193870,384346,578216,14.006,4.696,392513,584044,191531,14.148,4.64,8342929,65.9,61,5496129,5088767,407362,7.4
Ohio,1993,4157596,180207,58646,1.411,25.653,22218,9.688,20076,8.754,230415,12760,13265,79450,183438,408492,591930,14.237,4.412,367996,533284,165288,12.827,3.976,8396165,65.6,61.2,5508854,5141650,367204,6.7
Ohio,1994,4267595,183247,119248,2.794,23.948,23296,10.014,19812,8.517,234372,13085,13501,77376,204133,426114,630247,14.768,4.783,349043,510999,161956,11.974,3.795,8434068,66,62.3,5567716,5252226,315490,5.7
Ohio,1995,4408068,186952,170875,3.876,22.54,24605,10.392,19717,8.327,239224,13259,13707,84744,221405,446253,667658,15.146,5.023,339510,496783,157273,11.27,3.568,8480637,66.1,62.8,5603018,5329943,273075,4.9
Ohio,1996,4494347,187570,65890,1.466,25.587,23677,9.883,20835,8.697,240997,14062,14471,92372,219122,421756,640878,14.26,4.876,398077,574988,176911,12.794,3.936,8522956,66.4,63.1,5661818,5378614,283204,5
Ohio,1997,4577363,188423,68954,1.506,28.318,24951,10.322,23636,9.778,242386,14915,15415,100223,254481,462587,717068,15.666,5.56,428459,648114,219655,14.159,4.799,8547942,66.9,63.8,5719007,5453640,265367,4.6
Ohio,1998,4731818,190268,131267,2.774,24.626,22792,9.335,21209,8.687,244940,13493,13940,86581,221755,492147,713902,15.087,4.686,392383,582635,190252,12.313,4.021,8573928,66.6,63.8,5714432,5465939,248493,4.3
Ohio,1999,4812336,189995,21153,0.44,27.152,21859,8.911,21169,8.629,245657,13598,14144,94717,215598,458875,674473,14.016,4.48,425146,653320,228174,13.576,4.741,8596747,67,64.1,5757603,5508721,248882,4.3
Ohio,2000,4924450,189555,134875,2.739,25.298,21827,8.869,21204,8.616,246425,13387,13903,88027,239765,518001,757766,15.388,4.869,431697,622891,191194,12.649,3.883,8623110,67,64.3,5781442,5544340,237102,4.1
Ohio,2001,4938081,187906,-106987,-2.167,26.009,21667,8.816,22505,9.157,245346,13595,14247,97820,227456,414722,642178,13.005,4.606,511125,749165,238040,15.171,4.82,8667199,67.2,64.2,5821151,5566414,254737,4.4
Ohio,2002,4818784,186691,-173309,-3.597,29.455,24279,9.879,25003,10.174,245398,14207,14695,125612,270001,439692,709693,14.728,5.603,612175,883002,270827,18.324,5.62,8709513,66.9,63,5827493,5490092,337401,5.8
Ohio,2003,4738728,186488,6726,0.142,27.985,22732,9.268,22857,9.319,245209,13623,14046,89307,211852,457948,669800,14.135,4.471,457112,663074,205962,13.993,4.346,8751391,67,62.8,5862996,5498959,364037,6.2
Ohio,2004,4735555,187037,-17884,-0.378,25.909,22728,9.246,21576,8.777,246398,13437,13926,102053,201867,411599,613466,12.954,4.263,407614,631350,223736,13.332,4.725,8784378,66.6,62.5,5853714,5487218,366496,6.3
Ohio,2005,4731480,186679,7223,0.153,26.961,22608,9.167,22237,9.017,246803,14149,14489,96115,223837,421205,645042,13.633,4.731,441957,637819,195862,13.48,4.14,8819792,66.7,62.7,5880691,5531429,349262,5.9
Ohio,2006,4766480,186168,63077,1.323,25.126,24810,10.016,23012,9.29,248600,15142,15512,92017,234965,426936,661901,13.887,4.93,401779,598824,197045,12.563,4.134,8859318,67.2,63.6,5957220,5635968,321252,5.4
Ohio,2007,4777938,183685,-45717,-0.957,26.448,23502,9.478,24603,9.922,247418,15016,15345,96339,225590,406247,631837,13.224,4.721,457051,677554,220503,14.181,4.615,8899484,67.6,63.8,6017203,5679258,337945,5.6
Ohio,2008,4729183,179423,-50642,-1.071,25.52,19922,8.133,24621,10.052,242599,15243,15601,108673,199575,403863,603438,12.76,4.22,427849,654080,226231,13.831,4.784,8929752,67.2,62.8,6002468,5609101,393367,6.6
Ohio,2009,4585950,173931,-257067,-5.606,21.005,17821,7.422,24392,10.159,236824,15083,15559,103061,180695,300939,481634,10.502,3.94,535852,738701,202849,16.108,4.423,8953903,65.9,59.2,5904847,5304803,600044,10.2
Ohio,2010,4402066,170225,-111345,-2.529,21.011,17460,7.435,21527,9.167,232791,12571,13034,77392,146817,315650,462467,10.506,3.335,419743,573812,154069,13.035,3.5,8970327,65.5,58.7,5871473,5267304,604169,10.3
Ohio,2011,4390002,168636,73408,1.672,21.403,18211,7.851,19908,8.583,231097,11912,12442,73595,142194,401010,543204,12.374,3.239,323354,469796,146442,10.701,3.336,8996691,64.2,58.5,5773480,5263728,509752,8.8
Ohio,2012,4475640,168723,100571,2.247,21.919,18975,8.211,18918,8.187,231108,10943,11362,74566,156589,434494,591083,13.207,3.499,332334,490512,158178,10.96,3.534,9023547,63.3,58.6,5712475,5290392,422083,7.4
Ohio,2013,4539495,167515,27424,0.604,22.716,18043,7.822,18764,8.135,230302,11152,11409,68116,152737,390288,543025,11.962,3.365,343407,515601,172194,11.358,3.793,9060002,63,58.3,5706777,5281459,425318,7.5
Ohio,2014,4583610,166782,54396,1.187,20.502,18030,7.817,17455,7.568,230939,10660,10968,64844,161360,362903,524263,11.438,3.52,339799,469867,130068,10.251,2.838,9097253,62.8,59.2,5713176,5381787,331389,5.8
Ohio,2015,4648183,166656,70090,1.508,21.087,19325,8.338,17677,7.627,232601,10567,10867,73427,171279,388887,560166,12.051,3.685,347923,490076,142153,10.543,3.058,9127141,62.6,59.5,5710776,5427850,282926,5
Ohio,2016,4732578,166763,81163,1.715,19.812,19739,8.424,16300,6.956,236051,10535,10874,70184,166272,383705,549977,11.621,3.513,337999,468814,130815,9.906,2.764,9158368,62.8,59.7,5754480,5464097,290383,5
Ohio,2017,4783188,165552,35919,0.751,23.558,17912,7.632,20616,8.784,233353,10657,11050,83951,179317,420011,599328,12.53,3.749,366814,563409,196595,11.779,4.11,9236379,63,59.9,5818975,5529479,289496,5
Ohio,2018,4829804,164944,53725,1.112,21.555,16923,7.272,18023,7.744,232173,10518,10823,68031,157192,417062,574254,11.89,3.255,360340,520529,160189,10.777,3.317,9267912,62.8,60,5819989,5558124,261865,4.5
Ohio,2019,4867159,165063,49749,1.022,19.731,17432,7.508,17494,7.535,232133,10758,11000,72569,153670,376259,529929,10.888,3.157,327129,480180,153051,9.866,3.145,9298346,63.2,60.6,5879395,5634934,244461,4.2
Ohio,2020,4915342,163598,3012,0.061,21.991,17162,7.424,19107,8.266,230191,11151,11504,77081,170959,372521,543480,11.057,3.478,375946,540468,164522,10.996,3.347,9312843,61.6,56.6,5736620,5266859,469761,8.2
Ohio,2021,4853787,165169,-144295,-2.973,22.934,20695,8.968,19530,8.463,231343,11110,11572,74145,168719,387855,556574,11.467,3.476,523673,700869,177196,14.44,3.651,9304325,61.4,58.2,5708982,5415608,293374,5.1
Ohio,2022,4821026,166882,128991,2.676,24.837,21526,9.276,19991,8.614,232841,12645,13121,77916,195817,531885,727702,15.094,4.062,389918,598711,208793,12.419,4.331,9317787,61.5,59.1,5733131,5503265,229866,4
Oklahoma,1978,766467,52008,67861,8.854,29.895,9912,16.709,7649,12.894,60452,5677,5729,28160,69998,112430,182428,23.801,9.133,68748,114567,45819,14.947,5.978,2112167,60.1,58.1,1269116,1226638,42478,3.3
Oklahoma,1979,828890,53974,60922,7.35,29.097,9937,16.113,7475,12.121,62901,5581,5625,29992,65998,115514,181512,21.898,7.962,73590,120590,47000,14.548,5.67,2162917,60.6,58.7,1311213,1270580,40633,3.1
Oklahoma,1980,872342,54925,30323,3.476,32.756,9385,14.786,8126,12.802,64103,6016,6081,32193,67926,105271,173197,19.854,7.787,92626,142874,50248,16.378,5.76,2218583,61.7,59.1,1368350,1311880,56470,4.1
Oklahoma,1981,912536,56393,58008,6.357,29.053,10173,15.634,8125,12.487,66093,6181,6268,30303,75632,114936,190568,20.883,8.288,88346,132560,44214,14.527,4.845,2271750,63,60.7,1430931,1380025,50906,3.6
Oklahoma,1982,968699,57875,53711,5.545,33.111,10748,16.025,8835,13.173,68025,6600,6671,36696,78651,135433,214084,22.1,8.119,104655,160373,55718,16.556,5.752,2350167,63.3,59.5,1488608,1398011,90597,6.1
Oklahoma,1983,958333,58985,-71997,-7.513,33.905,10214,14.889,8998,13.116,69211,6761,6843,42610,66691,95770,162461,16.952,6.959,165878,234458,68580,24.465,7.156,2416333,63.4,58.2,1531400,1407490,123910,8.1
Oklahoma,1984,926556,60668,13216,1.426,35.258,11026,15.712,9087,12.949,71144,6976,7057,37937,71642,104916,176558,19.055,7.732,103905,163342,59437,17.629,6.415,2422833,63.8,59.5,1545960,1441406,104554,6.8
Oklahoma,1985,952757,59835,46700,4.902,35.081,9985,14.108,10696,15.113,70420,8192,8264,47806,100070,113749,213819,22.442,10.503,96407,167119,70712,17.541,7.422,2406250,64.7,60.1,1557552,1446639,110913,7.1
Oklahoma,1986,964087,58201,-24633,-2.555,33.491,9348,13.394,10586,15.167,69175,7925,8035,40562,70849,90593,161442,16.746,7.349,119850,186075,66225,19.301,6.869,2419417,65.4,59.9,1581144,1449909,131235,8.3
Oklahoma,1987,937693,56076,-128816,-13.738,33.451,8852,12.979,10848,15.905,67205,7549,7698,44587,72474,84362,156836,16.726,7.729,208875,285652,76777,30.463,8.188,2401333,64.6,60,1551114,1440122,110992,7.2
Oklahoma,1988,882379,55494,13182,1.494,36,8785,13.085,9142,13.616,66961,6461,6659,41061,67488,104521,172009,19.494,7.648,90619,158827,68208,18,7.73,2385667,63.9,59.9,1525086,1428559,96527,6.3
Oklahoma,1989,903163,55612,26385,2.921,30.613,8551,12.744,8325,12.407,67210,5912,6024,32906,60330,104299,164629,18.228,6.68,82326,138244,55918,15.307,6.191,2386333,63.9,60.2,1524504,1437131,87373,5.7
Oklahoma,1990,928287,56266,22173,2.389,29.618,8375,12.393,7631,11.292,67953,5512,5639,30308,59017,100626,159643,17.198,6.358,87428,137470,50042,14.809,5.391,2346785,64.8,61.3,1520187,1438152,82035,5.4
Oklahoma,1991,944639,56721,13914,1.473,30.088,8663,12.658,7504,10.965,69017,5306,5440,34837,62761,93266,156027,16.517,6.644,86955,142113,55158,15.044,5.839,2363909,64,60.2,1512513,1422015,90498,6
Oklahoma,1992,952704,57042,8498,0.892,31.616,8229,11.885,7622,11.008,69543,5255,5371,31316,54973,104130,159103,16.7,5.77,95389,150605,55216,15.808,5.796,2389341,63.9,60.1,1526575,1436553,90022,5.9
Oklahoma,1993,964058,58458,12537,1.3,29.566,8185,11.667,6939,9.891,70781,4710,4795,27628,53272,101782,155054,16.083,5.526,94001,142517,48516,14.783,5.032,2413357,63.6,60,1534491,1447932,86559,5.6
Oklahoma,1994,987819,59635,28934,2.929,26.661,8554,11.955,7083,9.899,72286,5052,5131,26105,56639,103978,160617,16.26,5.734,87029,131683,44654,13.331,4.52,2434039,63.8,60.4,1552390,1469865,82525,5.3
Oklahoma,1995,1015746,60642,27479,2.705,26.18,8492,11.642,7168,9.827,73602,5240,5368,28820,55409,105029,160438,15.795,5.455,85942,132959,47017,13.09,4.629,2454138,63.6,60.8,1560406,1491125,69281,4.4
Oklahoma,1996,1037759,61078,30592,2.948,26.796,8598,11.64,7462,10.102,74435,5435,5544,30533,67039,102590,169629,16.346,6.46,89457,139037,49580,13.398,4.778,2482070,63.9,61.3,1586153,1522453,63700,4
Oklahoma,1997,1074738,61622,37134,3.455,30.03,9157,12.226,8277,11.051,75336,5692,5824,34437,70839,127669,198508,18.47,6.591,104733,161374,56641,15.015,5.27,2509419,64.1,61.6,1608679,1545046,63633,4
Oklahoma,1998,1130582,62372,45193,3.997,26.769,8518,11.202,7783,10.236,76405,5249,5421,33066,66204,130309,196513,17.382,5.856,94880,151320,56440,13.384,4.992,2535351,64.5,61.9,1634852,1568139,66713,4.1
Oklahoma,1999,1154760,62233,-2239,-0.194,32.215,8427,11.017,8287,10.834,76564,5484,5648,34882,68468,117537,186005,16.108,5.929,116955,188244,71289,16.302,6.173,2561616,64.6,62.4,1655671,1597948,57723,3.5
Oklahoma,2000,1178369,61959,43013,3.65,27.488,8102,10.575,8024,10.473,76656,5284,5449,30989,73106,131860,204966,17.394,6.204,103410,161953,58543,13.744,4.968,2579973,64.2,62.2,1655517,1605949,49568,3
Oklahoma,2001,1204862,61751,5629,0.467,30.363,8156,10.635,8109,10.573,76716,5165,5300,31334,68117,120430,188547,15.649,5.654,114636,182918,68282,15.182,5.667,2593587,64.5,62.1,1672620,1611746,60874,3.6
Oklahoma,2002,1200584,62314,-21020,-1.751,33.821,8883,11.502,8265,10.702,77540,4949,5096,38914,79672,123350,203022,16.91,6.636,143033,224042,81009,18.661,6.747,2611230,64.5,61.6,1685334,1607453,77881,4.6
Oklahoma,2003,1181483,62721,-18496,-1.565,29.652,8235,10.585,7646,9.828,78091,5104,5156,30200,58612,116552,175164,14.826,4.961,132248,193660,61412,16.391,5.198,2626130,64.2,60.8,1686378,1595412,90966,5.4
Oklahoma,2004,1179485,63605,13685,1.16,27.889,8373,10.646,7258,9.228,79207,4780,4892,28107,59702,118458,178160,15.105,5.062,109924,164475,54551,13.945,4.625,2638115,64.1,61.1,1690505,1610799,79706,4.7
Oklahoma,2005,1200812,64339,25799,2.148,25.951,8745,10.956,7511,9.41,80438,5094,5195,30188,68317,113292,181609,15.124,5.689,104621,155810,51189,12.975,4.263,2658130,64.3,61.5,1709289,1635004,74285,4.3
Oklahoma,2006,1246106,65210,62289,4.999,24.116,9425,11.607,7877,9.701,81973,5301,5450,27562,80671,131873,212544,17.057,6.474,98101,150255,52154,12.058,4.185,2690292,63.7,61.2,1714440,1647518,66922,3.9
Oklahoma,2007,1287467,65754,20309,1.577,29.716,9282,11.245,8046,9.748,83159,5285,5360,31629,70680,140918,211598,16.435,5.49,129913,191289,61376,14.858,4.767,2716737,63.4,60.9,1723271,1654796,68475,4
Oklahoma,2008,1311156,65927,23501,1.792,26.854,8635,10.343,7897,9.459,83857,5334,5464,28779,67993,131556,199549,15.219,5.186,120858,176048,55190,13.427,4.209,2743197,63.5,61.2,1740886,1678409,62477,3.6
Oklahoma,2009,1304546,65680,-40960,-3.14,24.289,7561,9.006,8050,9.589,83709,5453,5555,37643,54273,104159,158432,12.145,4.16,134588,199392,64804,15.284,4.968,2774079,63.8,59.6,1769447,1653357,116090,6.6
Oklahoma,2010,1260337,64946,-45939,-3.645,22.257,7028,8.43,7723,9.264,83022,5003,5072,26505,55272,84983,140255,11.128,4.385,132815,186194,53379,14.773,4.235,2832710,62.3,58.3,1765708,1650502,115206,6.5
Oklahoma,2011,1250021,64650,24786,1.983,22.267,7486,9.015,7423,8.939,83075,4960,5117,23700,48240,115717,163957,13.116,3.859,96648,139171,42523,11.133,3.402,2867951,61.6,58.2,1767056,1668235,98821,5.6
Oklahoma,2012,1279352,65162,31989,2.5,23.443,7814,9.369,7132,8.551,83746,4484,4613,24578,58867,123083,181950,14.222,4.601,102444,149961,47517,11.722,3.714,2894377,62,58.9,1794901,1703624,91277,5.1
Oklahoma,2013,1307204,65523,24910,1.906,23.075,7660,9.12,7126,8.484,84256,4521,4637,27820,57666,118060,175726,13.443,4.411,98627,150816,52189,11.537,3.992,2921037,61.6,58.4,1799525,1707220,92305,5.1
Oklahoma,2014,1336828,65874,35394,2.648,21.633,7633,9.017,6867,8.112,85038,4593,4658,27765,56534,123456,179990,13.464,4.229,95698,144596,48898,10.816,3.658,2945666,61,58.4,1797769,1719826,77943,4.3
Oklahoma,2015,1360582,65933,12242,0.9,23.605,7846,9.193,7240,8.483,85650,4779,4869,25527,59790,113034,172824,12.702,4.394,106329,160582,54253,11.802,3.987,2971677,61.5,58.9,1829046,1750501,78545,4.3
Oklahoma,2016,1362038,65611,-10867,-0.798,24.121,7946,9.251,7451,8.674,86144,5015,5106,26421,57524,106746,164270,12.061,4.223,128626,175137,46511,12.858,3.415,2990341,61.1,58.3,1828055,1743225,84830,4.6
Oklahoma,2017,1354591,65424,4516,0.333,25.207,7540,8.772,7877,9.165,85782,4789,4903,30187,57867,117375,175242,12.937,4.272,113430,170726,57296,12.604,4.23,2987388,61.1,58.7,1826272,1752733,73539,4
Oklahoma,2018,1368810,65485,21101,1.542,23.596,7413,8.649,7483,8.731,85674,4747,4862,26188,54511,128084,182595,13.34,3.982,107852,161494,53642,11.798,3.919,2997373,61.1,59.1,1831256,1771251,60005,3.3
Oklahoma,2019,1391021,65840,20292,1.459,21.682,7757,9.027,7241,8.426,86191,4862,5038,27316,54773,116319,171092,12.3,3.938,108025,150800,42775,10.841,3.075,3014372,61.2,59.2,1843331,1785400,57931,3.1
Oklahoma,2020,1402407,65352,2587,0.184,24.36,7767,9.029,8109,9.427,85849,5234,5331,27210,62980,110417,173397,12.364,4.491,120477,170810,50333,12.18,3.589,3029590,60.8,57,1842829,1726786,116043,6.3
Oklahoma,2021,1378208,66022,-60091,-4.36,21.929,8533,9.895,7753,8.991,86623,4970,5147,26392,52936,98175,151111,10.964,3.841,160526,211202,50676,15.324,3.677,3053574,61.1,58.7,1866370,1791369,75001,4
Oklahoma,2022,1366798,66286,40424,2.958,23.399,8545,9.862,8402,9.697,86718,5759,5964,31381,54305,146030,200335,14.657,3.973,102786,159911,57125,11.7,4.179,3082573,61.8,59.9,1903508,1845328,58180,3.1
Oregon,1978,743307,50124,108376,14.58,24.564,10501,18.787,6393,11.437,57950,4671,4705,23777,66690,132979,199669,26.862,8.972,52957,91293,38336,12.282,5.157,1862167,64.9,61,1208992,1135451,73541,6.1
Oregon,1979,820544,52458,39217,4.779,30.645,9765,16.445,7209,12.14,60659,5152,5210,26954,58330,106616,164946,20.102,7.109,79177,125729,46552,15.323,5.673,1923417,64.8,60.4,1246661,1162665,83996,6.7
Oregon,1980,846060,53445,3980,0.47,35.208,9560,15.59,8265,13.479,61967,6072,6189,31328,60722,92198,152920,18.074,7.177,96963,148940,51977,17.604,6.143,1973917,65.3,59.9,1289890,1181682,108208,8.4
Oregon,1981,836642,53612,-19050,-2.277,32.168,8925,14.378,8597,13.849,62239,6247,6333,29729,55351,79213,134564,16.084,6.616,106044,153614,47570,18.361,5.686,1998250,66.4,60,1327737,1198694,129043,9.7
Oregon,1982,802052,51559,-59311,-7.395,29.286,8240,13.401,9809,15.953,60702,7119,7209,32667,48876,68569,117445,14.643,6.094,127013,176756,49743,22.038,6.202,2003250,66.2,58.7,1326493,1175980,150513,11.3
Oregon,1983,766070,51736,-13808,-1.802,33.418,8382,13.784,8233,13.539,60883,5632,5767,29074,44638,83366,128004,16.709,5.827,94405,141812,47407,18.512,6.188,2007750,66.7,59.5,1339509,1194251,145258,10.8
Oregon,1984,783098,54403,51022,6.515,27.73,9785,15.703,6934,11.128,63737,5019,5086,22651,53807,105790,159597,20.38,6.871,70743,108575,37832,13.865,4.831,2022833,65.9,59.8,1334030,1209783,124247,9.3
Oregon,1985,820702,54982,25481,3.105,32.247,9184,14.356,8717,13.626,64208,6278,6458,33893,56467,101339,157806,19.228,6.88,77963,132325,54362,16.123,6.624,2027250,65.5,59.8,1327140,1212361,114779,8.6
Oregon,1986,844512,56404,21118,2.501,32.161,9812,15.07,7992,12.275,66018,5771,5833,32887,60950,95969,156919,18.581,7.217,84118,135801,51683,16.08,6.12,2055500,66.3,61,1363105,1254853,108252,7.9
Oregon,1987,872119,57408,34395,3.944,32.345,10215,15.285,8637,12.923,67621,6139,6196,35827,66978,108460,175438,20.116,7.68,81556,141043,59487,16.172,6.821,2084417,66.9,62.8,1394572,1308765,85807,6.2
Oregon,1988,911348,58554,43159,4.736,32.147,9783,14.287,8309,12.134,69213,5841,5971,36035,70334,119309,189643,20.809,7.718,84553,146484,61931,16.073,6.796,2121917,67.4,63.6,1430996,1349323,81673,5.7
Oregon,1989,954758,60063,45449,4.76,30.913,9851,14.027,7870,11.206,71220,5603,5744,32076,67978,125042,193020,20.217,7.12,84604,147571,62967,15.456,6.595,2159750,68,64.3,1468247,1389582,78665,5.4
Oregon,1990,997667,61217,41997,4.21,28.814,9477,13.175,8066,11.213,72638,5735,5865,34700,64759,120972,185731,18.617,6.491,90138,143734,53596,14.407,5.372,2193841,68.2,64.5,1495969,1415384,80585,5.4
Oregon,1991,1021058,61656,4155,0.407,33.854,9954,13.574,8399,11.453,74109,5877,6077,40473,72017,104973,176990,17.334,7.053,110616,172835,62219,16.927,6.094,2244004,67.6,63.4,1515979,1422487,93492,6.2
Oregon,1992,1024585,62701,11058,1.079,32.883,9397,12.592,8198,10.985,75229,5302,5395,31938,66541,112973,179514,17.521,6.494,105134,168456,63322,16.441,6.18,2292833,68,63,1558153,1444655,113498,7.3
Oregon,1993,1041386,64372,24996,2.4,29.22,9252,12.184,7816,10.293,76652,5108,5189,23811,54289,122853,177142,17.01,5.213,103665,152146,48481,14.61,4.655,2349663,68.2,63.4,1602103,1490337,111766,7
Oregon,1994,1087407,67207,57130,5.254,25.636,10797,13.765,7438,9.483,80115,5192,5298,27585,70887,125629,196516,18.072,6.519,91921,139386,47465,12.818,4.365,2398575,68.5,64.8,1641975,1554657,87318,5.3
Oregon,1995,1142530,69320,55382,4.847,25.81,10804,13.273,8212,10.088,82696,5789,5938,32720,71069,131759,202828,17.753,6.22,95996,147446,51450,12.905,4.503,2448071,67.9,64.7,1663019,1583822,79197,4.8
Oregon,1996,1187392,70649,51643,4.349,26.288,10669,12.787,8511,10.201,84515,6063,6191,33987,70303,137410,207713,17.493,5.921,103864,156070,52206,13.144,4.397,2500567,68.5,64.7,1713057,1617621,95436,5.6
Oregon,1997,1248159,71795,46613,3.735,30.245,11021,12.926,9640,11.307,85951,6449,6553,35235,78037,157331,235368,18.857,6.252,119921,188755,68834,15.123,5.515,2544480,68.6,64.8,1745396,1648734,96662,5.5
Oregon,1998,1292502,73023,24512,1.896,29.26,10459,12.048,9302,10.716,87386,6081,6176,33500,76930,136672,213602,16.526,5.952,121966,189090,67124,14.63,5.193,2581476,68.9,65,1777608,1677094,100514,5.7
Oregon,1999,1311709,73482,16974,1.294,29.577,10356,11.784,9401,10.698,88357,6335,6511,38649,72694,138260,210954,16.082,5.542,118634,193980,75346,14.788,5.744,2613722,68.4,64.6,1787762,1689752,98010,5.5
Oregon,2000,1336847,73661,23805,1.781,29.403,9921,11.195,9472,10.688,88845,6271,6465,34106,81662,138679,220341,16.482,6.109,131236,196536,65300,14.701,4.885,2642542,68.6,65,1811837,1717623,94214,5.2
Oregon,2001,1352653,73811,12276,0.908,30.184,10470,11.748,9807,11.004,89454,6292,6482,33281,80669,135748,216417,15.999,5.964,135995,204141,68146,15.092,5.038,2679820,67.7,63.4,1815076,1699359,115717,6.4
Oregon,2002,1346260,73520,-37649,-2.797,31.779,10661,11.875,10549,11.75,89835,6381,6527,44903,81657,132258,213915,15.89,6.065,168454,251564,83110,18.686,6.173,2720797,67.4,62.4,1834254,1696894,137360,7.5
Oregon,2003,1327820,74894,4813,0.362,30.017,10834,11.965,9291,10.261,91322,5789,5888,29849,62441,141655,204096,15.371,4.703,129197,199283,70086,15.008,5.278,2754793,67,61.7,1846328,1698482,147846,8
Oregon,2004,1340652,76325,17002,1.268,26.023,10813,11.726,9053,9.817,93096,5880,5980,32177,68057,123383,191440,14.28,5.076,109104,174438,65334,13.011,4.873,2781851,66.3,61.5,1845407,1709561,135846,7.4
Oregon,2005,1375639,78666,52422,3.811,23.69,11866,12.56,9151,9.686,95832,5913,6066,30130,79456,135909,215365,15.656,5.776,106449,162943,56494,11.845,4.107,2823513,65.5,61.4,1848897,1734710,114187,6.2
Oregon,2006,1430576,81107,54865,3.835,24.046,12785,13.104,9333,9.566,99288,6466,6521,30385,81129,145736,226865,15.858,5.671,119548,172000,52452,12.023,3.666,2876527,65.4,61.9,1881770,1780651,101119,5.4
Oregon,2007,1469845,82658,15158,1.031,27.375,12187,12.144,10017,9.982,101436,6592,6694,33315,72326,144015,216341,14.719,4.921,137404,201183,63779,13.687,4.339,2926092,65.3,61.9,1910890,1812303,98587,5.2
Oregon,2008,1478110,82107,-1691,-0.114,27.073,10737,10.602,10983,10.845,101152,7387,7500,35006,62732,137355,200087,13.537,4.244,139491,201778,62287,13.651,4.214,2970432,65.5,61.4,1946539,1825256,121283,6.2
Oregon,2009,1419266,78662,-110613,-7.794,21.712,8897,8.93,12571,12.617,97798,8250,8373,41311,57188,96886,154074,10.856,4.029,193921,264687,70766,18.65,4.986,3008002,65.4,58.3,1968365,1755156,213209,10.8
Oregon,2010,1339016,77446,-28243,-2.109,22.883,9600,9.864,10573,10.864,96835,6613,6751,28570,53701,99502,153203,11.441,4.01,128544,181446,52902,13.551,3.951,3034354,65.6,58.6,1991749,1778034,213715,10.7
Oregon,2011,1333126,77052,14998,1.125,22.93,9543,9.87,9802,10.138,96558,6248,6446,27342,47837,120003,167840,12.59,3.588,102126,152842,50716,11.465,3.804,3066901,65.1,58.8,1995931,1804257,191674,9.6
Oregon,2012,1353238,77582,26016,1.923,22.316,9635,9.963,9305,9.622,96872,5473,5562,24912,52665,124348,177013,13.081,3.892,103885,150997,47112,11.158,3.481,3098061,63.4,57.8,1964662,1791248,173414,8.8
Oregon,2013,1382223,78359,30472,2.205,22.126,9835,10.097,8714,8.946,97967,5381,5467,24975,55081,128307,183388,13.268,3.985,98964,152916,53952,11.063,3.903,3126399,61.6,56.8,1924692,1775139,149553,7.8
Oregon,2014,1416494,79382,36388,2.569,21.13,9905,10.037,8493,8.606,99395,5436,5509,23806,56640,129401,186041,13.134,3.999,99866,149653,49787,10.565,3.515,3164439,61.6,57.5,1950128,1820202,129926,6.7
Oregon,2015,1464778,80991,58859,4.018,19.797,10408,10.351,8109,8.065,101698,5234,5291,26085,64223,139625,203848,13.917,4.384,97250,144989,47739,9.898,3.259,3214603,61.6,58.2,1979475,1871286,108189,5.5
Oregon,2016,1522747,82714,49709,3.264,19.408,10681,10.385,8384,8.151,104002,5490,5587,26542,60963,136511,197474,12.968,4.003,98811,147765,48954,9.704,3.215,3279335,62.3,59.3,2042929,1946233,96696,4.7
Oregon,2017,1570330,83781,46408,2.955,21.997,10623,10.139,9093,8.679,105536,5904,5997,28239,63158,155963,219121,13.954,4.022,117219,172713,55494,10.999,3.534,3327673,62.4,59.8,2075682,1991503,84179,4.1
Oregon,2018,1609957,85203,29644,1.841,21.496,10558,9.941,9133,8.599,106922,5963,6054,31107,58958,143725,202683,12.589,3.662,115814,173039,57225,10.748,3.554,3366596,61.8,59.3,2080051,1996490,83561,4
Oregon,2019,1634659,85766,18220,1.115,21.401,10294,9.588,9399,8.754,107811,6417,6497,30855,57697,135441,193138,11.815,3.53,121447,174918,53471,10.701,3.271,3402123,61.5,59.2,2091454,2013835,77619,3.7
Oregon,2020,1651705,85903,16481,0.998,21.367,10277,9.519,9958,9.223,108126,6576,6689,32199,65641,127298,192939,11.681,3.974,121070,176458,55388,10.683,3.353,3433590,61.4,56.7,2107241,1947540,159701,7.6
Oregon,2021,1616068,86009,-85291,-5.278,21.835,11000,10.165,10789,9.97,108323,6822,6984,36128,58007,118424,176431,10.917,3.589,195830,261722,65892,16.195,4.077,3454732,62.1,58.9,2144461,2033502,110959,5.2
Oregon,2022,1616420,88147,89899,5.562,22.981,12473,11.403,10285,9.403,110475,7135,7309,33878,78102,197532,275634,17.052,4.832,119609,185735,66126,11.491,4.091,3457785,62.5,60,2159953,2075083,84870,3.9
Pennsylvania,1978,3797071,177721,141769,3.734,28.043,24963,11.871,20597,9.794,212476,13479,13719,108486,201335,472834,674169,17.755,5.302,318709,532400,213691,14.021,5.628,8938917,59.3,55.2,5302387,4931079,371308,7
Pennsylvania,1979,3961436,182530,163536,4.128,23.211,23939,11.098,18691,8.665,218325,13088,13265,67172,172570,450708,623278,15.734,4.356,314742,459742,145000,11.605,3.66,9001833,59.7,55.6,5375725,5000786,374939,7
Pennsylvania,1980,4055109,181830,6130,0.151,26.109,21280,9.747,21504,9.85,218207,15281,15462,80218,170773,364724,535497,13.205,4.211,371901,529367,157466,13.054,3.883,9049333,60.1,55.2,5441173,4998878,442295,8.1
Pennsylvania,1981,4031438,179289,-39724,-0.985,25.137,20758,9.542,21897,10.065,216980,15583,15840,81789,189541,317153,506694,12.569,4.702,395992,546418,150426,13.554,3.731,9107000,60.1,55,5469725,5012400,457325,8.4
Pennsylvania,1982,3981438,176899,-40788,-1.024,27.076,21047,9.734,22601,10.453,215434,15553,15818,82666,178734,360282,539016,13.538,4.489,415121,579804,164683,14.563,4.136,9146000,59.9,53.4,5483006,4884993,598013,10.9
Pennsylvania,1983,3924582,180135,-86258,-2.198,28.407,23825,10.976,20639,9.508,218656,13593,13909,79630,189543,367882,557425,14.203,4.83,463197,643683,180486,16.401,4.599,9176417,59.7,53,5474633,4866442,608191,11.1
Pennsylvania,1984,3921429,184506,137502,3.506,25.136,25612,11.585,20884,9.446,223444,14139,14375,105575,189105,441247,630352,16.075,4.822,315013,492850,177837,12.568,4.535,9195167,59.7,54.4,5491972,5001555,490417,8.9
Pennsylvania,1985,4025479,186133,65840,1.636,27.271,26132,11.65,24367,10.863,225199,16686,17091,123720,197134,417603,614737,15.271,4.897,326370,548897,222527,13.636,5.528,9203667,60.3,55.4,5546950,5102804,444146,8
Pennsylvania,1986,4096341,191612,93033,2.271,27.772,28549,12.488,21585,9.442,232089,14920,15223,93128,237757,424090,661847,16.157,5.804,391635,568814,177179,13.886,4.325,9243500,60.8,56.6,5622267,5229656,392611,7
Pennsylvania,1987,4222033,196186,119481,2.83,28.705,29830,12.674,23287,9.894,238632,15800,16054,107448,264402,461055,725457,17.183,6.262,393461,605976,212515,14.353,5.033,9297500,60.9,57.4,5662387,5336800,325587,5.7
Pennsylvania,1988,4331941,201423,96530,2.228,28.848,29906,12.337,23132,9.543,245794,15935,16314,123620,256550,464825,721375,16.652,5.922,400712,624845,224133,14.424,5.174,9341750,61.7,58.5,5759491,5463388,296103,5.1
Pennsylvania,1989,4442657,205956,111685,2.514,26.353,28860,11.602,23202,9.328,251575,16098,16537,108473,236111,460951,697062,15.69,5.315,371746,585377,213631,13.176,4.809,9366750,62.3,59.2,5835018,5549309,285709,4.9
Pennsylvania,1990,4553773,209261,88556,1.945,24.92,27507,10.83,22828,8.988,256318,16386,16729,104080,208153,447805,655958,14.405,4.571,390787,567402,176615,12.46,3.878,9205919,63.2,59.7,5813610,5494639,318971,5.5
Pennsylvania,1991,4554170,207571,-101823,-2.236,26.29,26062,10.164,25224,9.837,256839,17731,18222,136812,222346,376293,598639,13.145,4.882,468390,700462,232072,15.381,5.096,9257368,63.1,58.7,5842300,5438620,403680,6.9
Pennsylvania,1992,4494144,205453,-51721,-1.151,27.731,23849,9.322,25244,9.868,255131,16575,16982,100561,208362,414779,623141,13.866,4.636,468142,674862,206720,15.016,4.6,9284189,63.5,58.8,5896228,5456078,440150,7.5
Pennsylvania,1993,4487723,206055,29080,0.648,26.227,22839,8.952,22790,8.933,255157,15261,15683,91469,190982,426599,617581,13.762,4.256,413972,588501,174529,13.114,3.889,9322176,63.3,58.9,5897205,5489881,407324,6.9
Pennsylvania,1994,4529388,205831,23796,0.525,26.357,23340,9.127,22828,8.927,255967,15470,15834,105816,206819,413879,620698,13.704,4.566,393239,596902,203663,13.178,4.496,9351246,63,59,5892395,5518891,373504,6.3
Pennsylvania,1995,4596517,208911,111337,2.422,23.118,25438,9.861,21370,8.284,260010,14562,15082,103028,217502,425146,642648,13.981,4.732,344053,531311,187258,11.559,4.074,9378316,62.9,59.2,5900111,5553073,347038,5.9
Pennsylvania,1996,4622838,208538,41832,0.905,25.146,24599,9.462,22520,8.662,261014,15600,16035,101828,222532,400531,623063,13.478,4.814,390940,581231,190291,12.573,4.116,9409219,63.6,60.1,5985348,5655464,329884,5.5
Pennsylvania,1997,4702029,209879,94647,2.013,27.372,26815,10.226,24513,9.348,263374,15737,16324,120047,254854,483304,738158,15.699,5.42,407924,643511,235587,13.686,5.01,9420957,64.3,61,6061222,5749513,311709,5.1
Pennsylvania,1998,4843631,212203,98390,2.031,24.582,24608,9.268,22191,8.358,266725,14211,14654,86406,215117,478611,693728,14.322,4.441,417084,595338,178254,12.291,3.68,9439610,64.2,61.2,6064102,5779951,284151,4.7
Pennsylvania,1999,4919644,212275,49800,1.012,26.056,23920,8.957,23401,8.763,267302,14902,15342,95877,234607,456112,690719,14.04,4.769,425305,640919,215614,13.028,4.383,9466514,64.4,61.5,6093277,5820571,272706,4.5
Pennsylvania,2000,5011295,212768,113139,2.258,24.784,23759,8.86,22592,8.425,268739,14292,14835,88358,241084,493056,734140,14.65,4.811,416530,621001,204471,12.392,4.08,9486292,64.4,61.6,6105742,5848152,257590,4.2
Pennsylvania,2001,5065369,212298,-365,-0.007,27.612,24700,9.184,23947,8.904,269315,14533,15239,108006,253283,446048,699331,13.806,5,456681,699696,243015,13.813,4.798,9515842,64.9,61.8,6178900,5882813,296087,4.8
Pennsylvania,2002,5055688,211976,-82541,-1.633,30.126,26629,9.851,26266,9.717,270486,15078,15645,126592,298765,462775,761540,15.063,5.909,546056,844081,298025,16.696,5.895,9559024,65,61.4,6214539,5869299,345240,5.6
Pennsylvania,2003,5000175,212666,-25058,-0.501,27.691,25255,9.318,24035,8.868,271641,14674,15126,95595,225079,467213,692292,13.845,4.501,487300,717350,230050,14.346,4.601,9606890,64.1,60.5,6157935,5808102,349833,5.7
Pennsylvania,2004,5018737,215116,60312,1.202,24.46,25408,9.309,22823,8.361,274247,14354,14656,91868,208330,465775,674105,13.432,4.151,401188,613793,212605,12.23,4.236,9649682,64.4,60.9,6212828,5878607,334221,5.4
Pennsylvania,2005,5064251,216393,8241,0.163,25.072,26441,9.599,24098,8.748,276626,15413,15781,88756,232198,410905,643103,12.699,4.585,438209,634862,196653,12.536,3.883,9702277,64.5,61.3,6256642,5943887,312755,5
Pennsylvania,2006,5129632,216642,115905,2.26,22.572,27981,10.055,24673,8.866,279927,16579,17027,94102,251622,443212,694834,13.545,4.905,396916,578929,182013,11.286,3.548,9767932,64.5,61.5,6297964,6002761,295203,4.7
Pennsylvania,2007,5184349,216016,-5281,-0.102,26.413,26288,9.395,26268,9.388,279805,15666,15995,92842,227496,457187,684683,13.207,4.388,459238,689964,230726,13.309,4.45,9829441,64.6,61.6,6346588,6057645,288943,4.6
Pennsylvania,2008,5192826,214057,24503,0.472,24.638,24165,8.65,24870,8.902,279018,15786,16110,88641,201612,462584,664196,12.791,3.883,437630,639693,202063,12.319,3.891,9888397,65.1,61.7,6439786,6096818,342968,5.3
Pennsylvania,2009,5120931,211045,-187098,-3.654,20.583,21672,7.795,25434,9.148,276159,15622,16030,110390,179791,347217,527008,10.291,3.511,503855,714106,210251,13.945,4.106,9939374,64.4,59.3,6400238,5890073,510165,8
Pennsylvania,2010,4994590,208149,-71009,-1.422,21.694,21260,7.733,23898,8.693,273593,14330,14704,79234,181422,360334,541756,10.847,3.632,438709,612765,174056,12.269,3.485,10049131,63.3,58.1,6360605,5838498,522107,8.2
Pennsylvania,2011,5012434,207423,93585,1.867,20.723,22231,8.121,21910,8.004,273905,13399,13747,70889,183891,429063,612954,12.229,3.669,364927,519369,154442,10.362,3.081,10119106,63.1,58.2,6381749,5886748,495001,7.8
Pennsylvania,2012,5102704,208282,87745,1.72,21.281,22218,8.105,21746,7.933,274353,12728,13134,77038,172734,457974,630708,12.36,3.385,372771,542963,170192,10.641,3.335,10156562,63.5,58.6,6449023,5955409,493614,7.7
Pennsylvania,2013,5153743,207623,9281,0.18,22.42,22391,8.15,21758,7.92,275049,13119,13302,88025,179970,407038,587008,11.39,3.492,406189,577727,171538,11.21,3.328,10181064,63.1,58.6,6419837,5962130,457707,7.1
Pennsylvania,2014,5195308,207190,69751,1.343,19.637,22042,8.008,21714,7.889,275398,13121,13446,77086,180572,399282,579854,11.161,3.476,351994,510103,158109,9.819,3.043,10205656,62.6,58.9,6389059,6010075,378984,5.9
Pennsylvania,2015,5263575,207016,55930,1.063,20.954,22596,8.19,21694,7.863,276340,13061,13429,77251,206986,400399,607385,11.539,3.932,378400,551455,173055,10.477,3.288,10218363,62.9,59.5,6423155,6076402,346753,5.4
Pennsylvania,2016,5321351,208278,57440,1.079,20.611,23640,8.503,20341,7.317,279657,12890,13197,79542,192828,413007,605835,11.385,3.624,381989,548395,166406,10.306,3.127,10232466,63.1,59.8,6458891,6114644,344247,5.3
Pennsylvania,2017,5380206,207527,73151,1.36,21.654,21891,7.84,22738,8.143,278814,13427,13726,75694,187896,467760,655656,12.186,3.492,396564,582505,185941,10.827,3.456,10357025,62.6,59.5,6485253,6161913,323340,5
Pennsylvania,2018,5447013,207432,49498,0.909,20.569,21953,7.868,21227,7.607,279396,12988,13205,75076,168438,441252,609690,11.193,3.092,388683,560192,171509,10.284,3.149,10388655,62.7,59.9,6509775,6222004,287771,4.4
Pennsylvania,2019,5515829,208625,85587,1.552,18.28,21862,7.814,21052,7.524,280199,13119,13478,80875,168057,421684,589741,10.692,3.047,341939,504154,162215,9.14,2.941,10411566,63.2,60.4,6576454,6291680,284774,4.3
Pennsylvania,2020,5531647,207834,6836,0.124,20.673,21633,7.724,21886,7.814,279952,13680,14085,87460,182843,395781,578624,10.46,3.305,405616,571788,166172,10.337,3.004,10437946,62.3,56.8,6506484,5929949,576535,8.9
Pennsylvania,2021,5396307,205967,-279468,-5.179,21.001,24522,8.8,27075,9.716,277377,14791,15394,82569,203801,362845,566646,10.501,3.777,644011,846114,202103,15.68,3.745,10470304,61.4,57.8,6431855,6054068,377787,5.9
Pennsylvania,2022,5435305,210606,294753,5.423,19.465,27551,9.849,22839,8.165,282078,14704,15194,81179,210834,612902,823736,15.155,3.879,348599,528983,180384,9.732,3.319,10466084,61.8,59.3,6465248,6202046,263202,4.1
Rhode Island,1978,314790,18071,21223,6.742,25.234,2425,12.237,1927,9.724,20066,1375,1382,8114,18386,42554,60940,19.359,5.841,22546,39717,17171,12.617,5.455,714333,63.1,59.1,450484,422048,28436,6.3
Rhode Island,1979,335128,18676,16933,5.053,23.922,2366,11.587,1750,8.57,20727,1245,1259,6837,17462,39556,57018,17.014,5.211,27343,40085,12742,11.961,3.802,719000,64.5,60.4,463528,434157,29371,6.3
Rhode Island,1980,342659,18732,-1530,-0.447,26.287,2116,10.199,2068,9.968,20771,1499,1509,6381,13039,31999,45038,13.144,3.805,34691,46568,11877,13.59,3.466,719917,65.4,60.7,470866,436772,34094,7.2
Rhode Island,1981,340633,18717,155,0.046,28.253,2156,10.362,2072,9.958,20849,1488,1496,7141,18276,29999,48275,14.172,5.365,35610,48120,12510,14.127,3.673,726417,65.6,60.7,476727,440627,36100,7.6
Rhode Island,1982,337332,18466,-6907,-2.048,26.925,2046,9.86,2297,11.07,20625,1645,1657,9068,15418,29996,45414,13.463,4.571,37387,52321,14934,15.51,4.427,731583,65.9,59.4,482361,434207,48154,10
Rhode Island,1983,332325,18568,-1567,-0.472,26.822,2206,10.711,2070,10.05,20664,1448,1456,7440,11280,33288,44568,13.411,3.394,31330,46135,14805,13.883,4.455,735417,65.4,59.9,480971,440461,40510,8.4
Rhode Island,1984,342757,19307,21914,6.393,21.81,2569,12.204,1879,8.926,21396,1328,1355,6862,16231,43061,59292,17.299,4.735,24954,37378,12424,10.905,3.625,741667,65.8,62.3,488313,462427,25886,5.3
Rhode Island,1985,356861,19710,5026,1.408,28.044,2684,12.414,2233,10.328,21846,1654,1677,11810,16819,38246,55065,15.43,4.713,32268,50039,17771,14.022,4.98,748000,66.7,63.5,498716,475325,23391,4.7
Rhode Island,1986,366818,20437,18606,5.072,23.004,2988,13.427,2144,9.634,22676,1540,1553,9148,20111,40686,60797,16.574,5.483,27313,42191,14878,11.502,4.056,754250,67.1,64.3,505908,485271,20637,4.1
Rhode Island,1987,385555,21214,17353,4.501,27.065,3367,14.536,2421,10.452,23636,1781,1809,12412,25635,43894,69529,18.034,6.649,31932,52176,20244,13.533,5.251,762250,67.4,65,514100,495173,18927,3.7
Rhode Island,1988,400335,21952,7790,1.946,29.866,3351,13.936,2603,10.825,24420,1873,1891,11515,24496,43077,67573,16.879,6.119,38209,59783,21574,14.933,5.389,767417,67.3,65.3,516617,501398,15219,2.9
Rhode Island,1989,403623,22393,-2293,-0.568,31.811,3260,13.188,2727,11.032,24986,2095,2112,16246,24556,39643,64199,15.906,6.084,40489,66492,26003,16.474,6.442,769667,67.4,64.8,518819,498615,20204,3.9
Rhode Island,1990,397296,22160,-11706,-2.946,26.728,2751,11.046,2905,11.664,24828,2246,2263,12291,21569,31526,53095,13.364,5.429,45470,64801,19331,16.311,4.866,775851,67.5,63.3,523343,490779,32564,6.2
Rhode Island,1991,378083,21248,-27047,-7.154,26.295,2434,9.98,3266,13.391,23973,2308,2343,15330,21314,28394,49708,13.147,5.637,53016,76755,23739,20.301,6.279,779699,67.4,61.7,525354,481114,44240,8.4
Rhode Island,1992,360987,20789,-4322,-1.197,31.057,2403,10.131,2890,12.185,23475,1898,1930,11828,22289,33767,56056,15.529,6.174,38240,60378,22138,16.726,6.133,779475,68,61.9,530333,482610,47723,9
Rhode Island,1993,361911,21164,8346,2.306,25.352,2625,11.094,2250,9.51,23848,1531,1564,8346,17522,36699,54221,14.982,4.842,30461,45875,15414,12.676,4.259,780168,67.1,62,523220,483861,39359,7.5
Rhode Island,1994,369198,21478,3383,0.916,28.724,2681,11.158,2366,9.847,24185,1671,1710,9469,23623,32784,56407,15.278,6.398,34094,53024,18930,14.362,5.127,781777,65.8,61.5,514760,480597,34163,6.6
Rhode Island,1995,367696,21699,7524,2.046,24.44,2602,10.698,2300,9.456,24473,1614,1635,7626,17332,35125,52457,14.266,4.714,30477,44933,14456,12.22,3.932,784053,65.3,61.1,511821,479387,32434,6.3
Rhode Island,1996,369286,21771,516,0.14,26.089,2590,10.577,2384,9.735,24591,1685,1695,8838,16224,32464,48688,13.184,4.393,32225,48172,15947,13.045,4.318,789329,65.7,62.3,518585,491480,27105,5.2
Rhode Island,1997,381224,22006,8571,2.248,26.752,2652,10.732,2438,9.866,24819,1726,1744,9757,19753,39810,59563,15.624,5.181,33817,50992,17175,13.376,4.505,794188,66.9,63.4,531429,503143,28286,5.3
Rhode Island,1998,396408,22353,14885,3.755,22.635,2475,9.884,2202,8.793,25178,1507,1520,6371,19670,40079,59749,15.073,4.962,33136,44864,11728,11.318,2.959,800630,66.5,63.4,532183,507973,24210,4.5
Rhode Island,1999,408773,22251,2089,0.511,25.884,2357,9.357,2348,9.321,25194,1648,1662,7745,16054,38938,54992,13.453,3.927,37515,52903,15388,12.942,3.764,806406,67,64.1,539926,517211,22715,4.2
Rhode Island,2000,415001,22353,7370,1.776,26.271,2437,9.63,2252,8.899,25398,1507,1546,8138,20395,41487,61882,14.911,4.914,34529,54512,19983,13.135,4.815,812627,66.8,64.1,542514,520813,21701,4
Rhode Island,2001,415537,22317,-3728,-0.897,25.046,2390,9.412,2342,9.223,25417,1519,1560,8395,16983,35054,52037,12.523,4.087,39740,55765,16025,13.42,3.856,819602,66.1,63.1,541661,517532,24129,4.5
Rhode Island,2002,416225,22222,3089,0.742,29.939,2655,10.407,2606,10.215,25536,1572,1588,9760,27567,37829,65396,15.712,6.623,42945,62307,19362,14.97,4.652,827928,66.5,63.1,550244,522201,28043,5.1
Rhode Island,2003,419424,22482,5464,1.303,25.645,2692,10.494,2429,9.469,25784,1487,1532,7904,18297,40948,59245,14.125,4.362,37357,53781,16424,12.823,3.916,834525,67.2,63.5,560785,529583,31202,5.6
Rhode Island,2004,429312,23082,12013,2.798,23.157,2925,11.187,2203,8.426,26507,1505,1512,8315,19322,42398,61720,14.376,4.501,33428,49707,16279,11.578,3.792,837494,66.4,62.9,555679,526489,29190,5.3
Rhode Island,2005,438678,23196,4073,0.928,22.726,2762,10.373,2536,9.524,26740,1680,1688,9102,20098,33822,53920,12.291,4.581,34581,49847,15266,11.363,3.48,837143,67.3,63.9,563439,534535,28904,5.1
Rhode Island,2006,440870,23517,475,0.108,27.844,3114,11.531,2568,9.509,27278,1736,1775,8822,23464,38389,61853,14.03,5.322,44480,61378,16898,13.922,3.833,837533,68.2,64.7,571586,541675,29911,5.2
Rhode Island,2007,442032,23291,2061,0.466,26.988,2736,10.043,2810,10.315,27205,1901,1919,11301,22106,39603,61709,13.96,5.001,39149,59648,20499,13.494,4.637,837511,68.2,64.7,571086,541956,29130,5.1
Rhode Island,2008,437249,22802,-11546,-2.641,23.091,2437,9.045,2935,10.893,26695,1918,1938,9204,16230,34253,50483,11.546,3.712,43116,62029,18913,14.186,4.325,838434,67.8,62.6,568229,525187,43042,7.6
Rhode Island,2009,420693,21811,-20675,-4.915,20.412,2039,7.782,3171,12.103,25634,2008,2036,10441,12962,29973,42935,10.206,3.081,45373,63610,18237,15.12,4.335,841735,67.9,60.1,571203,505930,65273,11.4
Rhode Island,2010,404785,21414,-14243,-3.519,21.067,2285,8.967,2602,10.211,25323,1650,1655,7563,16506,26133,42639,10.534,4.078,41529,56882,15353,14.052,3.793,842735,67.8,59.9,571505,504957,66548,11.6
Rhode Island,2011,400883,21187,7326,1.827,21.005,2301,9.111,2439,9.657,25187,1514,1540,6806,15809,33620,49429,12.33,3.944,26572,42103,15531,10.503,3.874,844463,66.6,59.2,562061,500109,61952,11
Rhode Island,2012,405013,21220,278,0.069,22.729,2331,9.253,2320,9.209,25198,1400,1418,6777,13529,32776,46305,11.433,3.34,32966,46027,13061,11.364,3.225,848001,66.1,59.3,560204,502897,57307,10.2
Rhode Island,2013,406846,21077,3453,0.849,20.176,2187,8.691,2244,8.917,25136,1401,1418,7184,12676,31820,44496,10.937,3.116,28033,41043,13010,10.088,3.198,850782,65.7,59.4,558747,505776,52971,9.5
Rhode Island,2014,413449,20989,10264,2.483,19.409,2219,8.821,2177,8.654,25177,1356,1366,6784,17178,33209,50387,12.187,4.155,27390,40123,12733,9.704,3.08,853716,65.2,60.1,556635,513406,43229,7.8
Rhode Island,2015,420817,21181,6044,1.436,18.975,2309,9.133,2096,8.291,25388,1278,1299,7608,13591,32378,45969,10.924,3.23,27800,39925,12125,9.488,2.881,855938,64.9,61,555272,521767,33505,6
Rhode Island,2016,428303,21516,9065,2.116,19.3,2573,10.02,1999,7.785,25966,1318,1333,6662,16965,33431,50396,11.766,3.961,29979,41331,11352,9.65,2.65,858159,64.5,61.1,553231,524438,28793,5.2
Rhode Island,2017,434656,21556,4459,1.026,21.805,2091,8.057,2106,8.115,25945,1287,1306,8515,14554,37293,51847,11.928,3.348,31450,47388,15938,10.902,3.667,882242,64.4,61.5,568144,542552,25592,4.5
Rhode Island,2018,439314,21515,6011,1.368,22.179,2145,8.303,2252,8.717,25782,1337,1373,7710,14893,39835,54728,12.458,3.39,30640,48717,18077,11.089,4.115,887694,64.5,61.9,572663,549529,23134,4
Rhode Island,2019,440597,21644,-3087,-0.701,19.168,2282,8.818,2074,8.014,25984,1383,1392,7965,13949,28278,42227,9.584,3.166,31674,45314,13640,10.285,3.096,891912,64.4,62.1,574066,553845,20221,3.5
Rhode Island,2020,442399,21604,6614,1.495,19.116,2173,8.365,2182,8.4,25972,1450,1455,6639,15671,33227,48898,11.053,3.542,28710,42284,13574,9.558,3.068,895384,63.7,57.9,570736,518282,52454,9.2
Rhode Island,2021,429255,21365,-32073,-7.472,17.307,2381,9.222,2682,10.388,25667,1461,1510,7264,12816,24330,37146,8.654,2.986,52900,69219,16319,16.125,3.802,897748,63.8,60.3,572546,540926,31620,5.5
Rhode Island,2022,425555,22121,24899,5.851,18.556,3012,11.554,2192,8.408,26480,1522,1540,7720,16549,47832,64381,15.129,3.889,26616,39482,12866,9.278,3.023,898428,63.6,61.6,571754,553588,18166,3.2
South Carolina,1978,893169,44592,69131,7.74,22.27,8114,15.687,5650,10.923,52957,3937,3984,16647,56724,111860,168584,18.875,6.351,62745,99453,36708,11.135,4.11,2117667,64.1,60.5,1356921,1281597,75324,5.6
South Carolina,1979,954230,45823,38264,4.01,23.44,7303,13.565,5791,10.756,54594,4153,4217,19991,45177,104922,150099,15.73,4.734,77365,111835,34470,11.72,3.612,2169417,63.4,60.2,1375201,1306773,68428,5
South Carolina,1980,952056,46294,14743,1.549,25.58,7065,12.857,6370,11.592,55300,4568,4651,19719,45520,90990,136510,14.338,4.781,85108,121767,36659,12.79,3.851,2221250,62.8,58.6,1395675,1301796,93879,6.7
South Carolina,1981,963325,46587,6611,0.686,27.961,7225,12.97,6366,11.428,56135,4661,4733,21551,55482,85805,141287,14.667,5.759,98177,134676,36499,13.98,3.789,2266583,63.2,58,1432219,1314907,117312,8.2
South Carolina,1982,957675,45753,-18010,-1.881,28.529,6815,12.184,7249,12.959,55719,5216,5269,26318,51281,85328,136609,14.265,5.355,112893,154619,41726,16.145,4.357,2307333,64.2,57.3,1482373,1322883,159490,10.8
South Carolina,1983,943107,47089,-14145,-1.5,29.932,7877,13.941,6344,11.228,57269,4525,4579,23623,51076,90068,141144,14.966,5.416,109393,155289,45896,16.466,4.866,2341083,63.2,56.9,1479137,1333162,145975,9.9
South Carolina,1984,972467,50208,65278,6.713,23.655,9985,16.915,6552,11.1,60746,4930,4981,26282,62369,117926,180295,18.54,6.413,69655,115017,45362,11.827,4.665,2378500,62.9,58.5,1495188,1391286,103902,6.9
South Carolina,1985,1046304,51769,35452,3.388,27.332,8830,14.316,6970,11.3,62610,5018,5092,29975,59691,118748,178439,17.054,5.705,91857,142987,51130,13.666,4.887,2426500,63.8,59.5,1548924,1443612,105312,6.8
South Carolina,1986,1057110,53445,41329,3.91,29.239,9230,14.486,6942,10.895,64860,4825,4909,28274,77237,118635,195872,18.529,7.306,102403,154543,52140,14.619,4.932,2455333,64.9,60.7,1592306,1491069,101237,6.4
South Carolina,1987,1103347,54917,46692,4.232,30.004,9809,14.861,7526,11.402,67148,5168,5247,30373,85728,126486,212214,19.234,7.77,103472,165522,62050,15.002,5.624,2495333,65.4,61.8,1631897,1542170,89727,5.5
South Carolina,1988,1164180,56660,66683,5.728,28.898,9847,14.396,7536,11.018,69555,5257,5365,31071,96076,138821,234897,20.177,8.253,101999,168214,66215,14.449,5.688,2533000,65.6,62.5,1660533,1583928,76605,4.6
South Carolina,1989,1217956,57984,47142,3.871,26.808,9425,13.374,7665,10.877,71351,5321,5413,31356,77256,133139,210395,17.274,6.343,104591,163253,58662,13.404,4.816,2566000,66,62.9,1693438,1615009,78429,4.6
South Carolina,1990,1267688,59373,51944,4.098,26.215,9581,13.255,7749,10.72,73200,5562,5702,33900,82769,135337,218106,17.205,6.529,108871,166162,57291,13.107,4.519,2611843,66.5,63.3,1737831,1652949,84882,4.9
South Carolina,1991,1280285,59463,-31079,-2.428,29.772,9652,13.093,8460,11.476,74313,5855,6040,44958,83499,107087,190586,14.886,6.522,146140,221665,75525,17.314,5.899,2663759,66.3,62.3,1767123,1659196,107927,6.1
South Carolina,1992,1271303,59650,16260,1.279,28.754,8711,11.701,8355,11.223,74626,5523,5614,32616,74158,124878,199036,15.656,5.833,124341,182776,58435,14.377,4.596,2699745,66.7,62.2,1799677,1678803,120874,6.7
South Carolina,1993,1292274,61028,24336,1.883,25.834,8844,11.74,7441,9.878,76031,4998,5105,26034,60955,130304,191259,14.8,4.717,109928,166923,56995,12.917,4.41,2739480,66.7,61.8,1826650,1693483,133167,7.3
South Carolina,1994,1327287,62381,43173,3.253,25.147,9223,11.987,7578,9.849,77763,5196,5316,33482,77290,132767,210057,15.826,5.823,109762,166884,57122,12.573,4.304,2775049,66.4,62.3,1841428,1727714,113714,6.2
South Carolina,1995,1374237,64148,50722,3.691,24.242,9889,12.537,7612,9.65,80020,5388,5560,34948,79700,137595,217295,15.812,5.8,107813,166573,58760,12.121,4.276,2813952,66.2,62.8,1864221,1768540,95681,5.1
South Carolina,1996,1407547,65273,27978,1.988,26.897,10094,12.503,8089,10.019,81736,5645,5803,34697,82199,135075,217274,15.436,5.84,129731,189296,59565,13.449,4.232,2851104,66.2,62.4,1886064,1779221,106843,5.7
South Carolina,1997,1437029,66660,30180,2.1,29.264,10733,12.972,8758,10.585,83725,5869,6011,42709,89126,151317,240443,16.732,6.202,131077,210263,79186,14.632,5.51,2897839,66.3,63.3,1920244,1834337,85907,4.5
South Carolina,1998,1503907,68227,64074,4.261,26.054,10324,12.152,8413,9.903,85910,5516,5619,31961,86736,173254,259990,17.288,5.767,129457,195916,66459,13.027,4.419,2945825,65.9,63.5,1940846,1870270,70576,3.6
South Carolina,1999,1549776,69462,29873,1.928,27.691,10260,11.837,8720,10.06,87446,5580,5851,35607,84583,159866,244449,15.773,5.458,142402,214576,72174,13.846,4.657,2989560,65.5,62.8,1958598,1877345,81253,4.1
South Carolina,2000,1597468,69790,32803,2.053,27.419,9649,10.984,8927,10.162,88209,5783,5940,35375,81206,170604,251810,15.763,5.083,147417,219007,71590,13.71,4.481,3027367,64.9,62.5,1965481,1892559,72922,3.7
South Carolina,2001,1607063,69624,-14421,-0.897,29.718,9738,11.032,9591,10.866,88342,6029,6289,43490,87108,151689,238797,14.859,5.42,165608,253218,87610,15.757,5.452,3064191,63.4,60,1941956,1839246,102710,5.3
South Carolina,2002,1577387,69983,-67316,-4.268,28.884,10370,11.667,9737,10.955,89199,5918,6074,47097,87934,139871,227805,14.442,5.575,203664,295121,91457,18.709,5.798,3098739,63.1,59,1954548,1828735,125813,6.4
South Carolina,2003,1548785,70996,9004,0.581,30.14,10187,11.344,8938,9.953,90427,5701,5787,37494,92362,150047,242409,15.652,5.964,149320,233405,84085,15.07,5.429,3133915,63.8,59.2,1999485,1855599,143886,7.2
South Carolina,2004,1563460,72445,13912,0.89,26.946,10255,11.229,8453,9.256,92230,5569,5672,35317,78691,145866,224557,14.363,5.033,140727,210645,69918,13.473,4.472,3178645,64.3,59.5,2043864,1891722,152142,7.4
South Carolina,2005,1583475,73985,24732,1.562,26.488,10909,11.691,8734,9.36,94401,5862,5971,35020,86436,148013,234449,14.806,5.459,144050,209717,65667,13.244,4.147,3234049,64,59.4,2071111,1919644,151467,7.3
South Carolina,2006,1624110,75720,52952,3.26,25.608,11801,12.319,8989,9.383,97204,6153,6307,33133,97362,163544,260906,16.065,5.995,142058,207954,65896,12.804,4.057,3305437,65,60.5,2148698,2001245,147453,6.9
South Carolina,2007,1657022,76673,9218,0.556,29.531,11652,11.872,9687,9.87,99133,6411,6559,40120,88768,165120,253888,15.322,5.357,165281,244670,79389,14.766,4.791,3374548,63.9,60,2155198,2024493,130705,6.1
South Carolina,2008,1662221,75804,2410,0.145,27.831,9828,9.936,10225,10.338,98710,6894,7004,37833,73527,160187,233714,14.06,4.423,158621,231304,72683,13.915,4.373,3439974,62.8,58.2,2160084,2002903,157181,7.3
South Carolina,2009,1603138,73018,-112636,-7.026,21.802,8750,8.977,11713,12.016,95995,7685,7967,44072,73248,101509,174757,10.901,4.569,207864,287393,79529,17.927,4.961,3490448,62.1,55,2166737,1919307,247430,11.4
South Carolina,2010,1530283,71504,-47161,-3.082,23.171,8584,9.01,10069,10.568,94534,6438,6618,34122,68580,108712,177292,11.586,4.482,161679,224453,62774,14.667,4.102,3564619,61,54.1,2174535,1928442,246093,11.3
South Carolina,2011,1520272,70401,28071,1.846,23.401,8488,9.023,9390,9.981,93624,6094,6274,32714,64041,141913,205954,13.547,4.212,123195,177883,54688,11.701,3.597,3612048,60.5,54.2,2185171,1957493,227678,10.4
South Carolina,2012,1543771,70476,29733,1.926,22.606,8327,8.898,8259,8.825,93617,5012,5151,24876,57736,146490,204226,13.229,3.74,121489,174493,53004,11.303,3.433,3655515,59.9,54.5,2190203,1992957,197246,9
South Carolina,2013,1570555,70694,25122,1.6,21.555,8381,8.942,8079,8.619,93881,5066,5178,25485,58341,136050,194391,12.377,3.715,118682,169269,50587,10.778,3.221,3704281,59.3,54.9,2197876,2034404,163472,7.4
South Carolina,2014,1591399,70998,41489,2.607,19.985,8678,9.207,7939,8.423,94625,5058,5153,25614,62511,138002,200513,12.6,3.928,108786,159024,50238,9.993,3.157,3759002,59.1,55.4,2222426,2082941,139485,6.3
South Carolina,2015,1639654,71964,49952,3.046,19.927,9243,9.694,7746,8.124,96100,4948,5044,28076,72126,141196,213322,13.01,4.399,111045,163370,52325,9.964,3.191,3822409,59.3,55.8,2267837,2134087,133750,5.9
South Carolina,2016,1693888,73315,54326,3.207,20.258,9568,9.835,7209,7.41,98464,4753,4883,27561,77199,148701,225900,13.336,4.558,123780,171574,47794,10.129,2.822,3888005,58.8,55.9,2286054,2174301,111753,4.9
South Carolina,2017,1734849,74392,38100,2.196,22.495,9314,9.388,7776,7.838,99980,4763,4871,33780,72430,160797,233227,13.444,4.175,129051,195127,66076,11.247,3.809,3897645,58,55.6,2261766,2166708,95058,4.2
South Carolina,2018,1785097,75654,41521,2.326,22.58,9395,9.342,8226,8.179,101154,4969,5119,28640,73055,170002,243057,13.616,4.092,135835,201536,65701,11.29,3.681,3948448,57.8,55.9,2282022,2205356,76666,3.4
South Carolina,2019,1823823,76776,40612,2.227,21.482,9663,9.474,8002,7.845,102829,5293,5393,32326,76284,160226,236510,12.968,4.183,132668,195898,63230,10.741,3.467,4002601,58.3,56.7,2333533,2268884,64649,2.8
South Carolina,2020,1852952,77252,10238,0.553,22.575,9600,9.295,8819,8.539,103673,5510,5713,31671,75012,144374,219386,11.84,4.048,146532,209148,62616,11.287,3.379,4050504,57.7,54.3,2339140,2199751,139389,6
South Carolina,2021,1846982,79728,-46971,-2.543,23.868,11430,10.89,8840,8.423,106249,5330,5568,30395,83438,136985,220423,11.934,4.518,195745,267394,71649,14.477,3.879,4109008,57.4,55.2,2359169,2266611,92558,3.9
South Carolina,2022,1870242,82003,61633,3.295,24.96,12047,11.2,9415,8.753,108875,6342,6466,33769,87013,208025,295038,15.775,4.653,157645,233405,75760,12.48,4.051,4188402,57.1,55.3,2393329,2316435,76894,3.2
South Dakota,1978,161621,14252,19623,12.141,23.233,2296,14.626,1669,10.632,16012,1179,1185,4615,13148,25250,38398,23.758,8.135,11124,18775,7651,11.617,4.734,490000,65.9,63.8,322731,312491,10240,3.2
South Dakota,1979,177069,14833,9480,5.354,26.934,2223,13.569,1586,9.681,16701,1167,1169,5330,12832,20494,33326,18.821,7.247,15486,23846,8360,13.467,4.721,492917,66.3,64.1,326963,315990,10973,3.4
South Dakota,1980,181494,14888,-456,-0.251,32.066,1903,11.357,1824,10.885,16796,1351,1358,5673,11153,17946,29099,16.033,6.145,20038,29555,9517,16.284,5.244,495333,67,63.9,331889,316282,15607,4.7
South Dakota,1981,178669,14672,-4820,-2.698,26.827,1766,10.575,1918,11.485,16624,1386,1396,5776,9365,14601,23966,13.414,5.242,19855,28786,8931,16.111,4.999,496750,67.2,64,333940,317740,16200,4.9
South Dakota,1982,175343,14404,-4153,-2.369,29.636,1782,10.798,2038,12.349,16375,1473,1486,6262,10814,15168,25982,14.818,6.167,20908,30135,9227,17.186,5.262,498667,66.9,63.3,333741,315629,18112,5.4
South Dakota,1983,172031,14509,-1849,-1.075,29.245,1844,11.225,1764,10.738,16468,1215,1239,5429,8887,16268,25155,14.622,5.166,18010,27004,8994,15.697,5.228,503667,66.8,63.3,336528,318987,17541,5.2
South Dakota,1984,176193,15053,10462,5.938,24.482,2224,13.258,1635,9.747,17069,1174,1185,4457,11387,20643,32030,18.179,6.463,13449,21568,8119,12.241,4.608,507167,67.2,64.2,340716,325839,14877,4.4
South Dakota,1985,184416,15036,5702,3.092,26.997,1969,11.541,1987,11.646,17052,1437,1465,6434,11749,18846,30595,16.59,6.371,15894,24893,8999,13.498,4.88,506250,68.4,65.1,346113,329350,16763,4.8
South Dakota,1986,186618,15021,-2041,-1.094,29.656,1849,10.826,1828,10.703,17090,1275,1282,6079,10385,17287,27672,14.828,5.565,20282,29713,9431,15.922,5.054,511250,68.5,65.3,350108,333947,16161,4.6
South Dakota,1987,190285,15129,7783,4.09,27.555,2013,11.732,1880,10.957,17225,1315,1320,5746,14142,19857,33999,17.867,7.432,17156,26216,9060,13.777,4.761,515083,68.5,65.5,352681,337480,15201,4.3
South Dakota,1988,197655,15310,5198,2.63,27.827,1959,11.283,1715,9.877,17485,1177,1202,6151,12452,20247,32699,16.544,6.3,17058,27501,10443,13.914,5.283,518417,68.9,66,357032,342341,14691,4.1
South Dakota,1989,204362,15519,8495,4.157,24.437,1948,11.038,1628,9.225,17808,1173,1186,5465,9812,23653,33465,16.375,4.801,15344,24970,9626,12.219,4.71,519000,69.5,66.9,360907,346964,13943,3.9
South Dakota,1990,213826,15936,10477,4.9,23.964,2116,11.722,1654,9.163,18282,1194,1209,5035,12889,23209,36098,16.882,6.028,15161,25621,10460,11.982,4.892,500932,69.7,67.2,349299,336623,12676,3.6
South Dakota,1991,223968,16093,11795,5.266,25.513,2129,11.515,1663,8.995,18722,1204,1216,6462,16979,23387,40366,18.023,7.581,19032,28571,9539,12.757,4.259,505393,70.1,67.6,354181,341730,12451,3.5
South Dakota,1992,235343,16226,10427,4.431,24.636,1988,10.572,1777,9.45,18909,1171,1182,5968,12630,26787,39417,16.749,5.367,19457,28990,9533,12.318,4.051,511043,70.6,68.2,360930,348484,12446,3.4
South Dakota,1993,243677,16588,7134,2.928,24.862,1943,10.186,1614,8.462,19239,1087,1115,5415,10965,26461,37426,15.359,4.5,21393,30292,8899,12.431,3.652,519692,70.7,68.2,367165,354406,12759,3.5
South Dakota,1994,253191,17084,10382,4.1,22.585,2172,11.103,1593,8.143,19852,1136,1157,5843,13611,25363,38974,15.393,5.376,19070,28592,9522,11.293,3.761,529175,71.2,68.8,376619,364252,12367,3.3
South Dakota,1995,264430,17429,12053,4.558,19.947,2052,10.228,1630,8.125,20273,1168,1190,5577,11661,26765,38426,14.532,4.41,16553,26373,9820,9.974,3.714,537657,71.5,69.3,384621,372395,12226,3.2
South Dakota,1996,271648,17584,6314,2.324,24.223,2155,10.592,1812,8.906,20518,1309,1343,6598,15668,23546,39214,14.436,5.768,21987,32900,10913,12.111,4.017,545307,71.6,69.2,390438,377606,12832,3.3
South Dakota,1997,277318,17655,4440,1.601,27.178,2211,10.738,2062,10.014,20665,1353,1398,7217,15282,26843,42125,15.19,5.511,23948,37685,13737,13.589,4.954,548956,71.7,69.6,393844,382286,11558,2.9
South Dakota,1998,287859,17912,10990,3.818,21.568,2128,10.198,1904,9.125,20978,1330,1367,6389,12264,29768,42032,14.602,4.26,20686,31042,10356,10.784,3.598,551772,72.1,70.1,398001,386618,11383,2.9
South Dakota,1999,295629,17964,4866,1.646,23.764,2070,9.836,1952,9.275,21105,1344,1382,6299,14774,25218,39992,13.528,4.997,22902,35126,12224,11.882,4.135,556421,72.5,70.5,403381,392449,10932,2.7
South Dakota,2000,303526,18052,7954,2.621,24.984,1978,9.337,1859,8.775,21245,1271,1317,6077,13803,32068,45871,15.113,4.548,25631,37917,12286,12.492,4.048,561564,72.7,70.9,408496,398124,10372,2.5
South Dakota,2001,310831,18069,5251,1.689,25.804,2039,9.566,1972,9.252,21348,1277,1301,6624,20886,24469,45355,14.592,6.719,27674,40104,12430,12.902,3.999,566359,73,70.8,413493,401072,12421,3
South Dakota,2002,307332,18294,-12793,-4.163,28.272,2417,11.201,2039,9.449,21767,1297,1317,9298,16409,27035,43444,14.136,5.339,37134,56237,19103,18.298,6.216,571138,73,70.6,416793,403343,13450,3.2
South Dakota,2003,301884,18452,1593,0.528,26.239,2142,9.822,2034,9.326,21863,1251,1269,6436,12773,28426,41199,13.647,4.231,25320,39606,14286,13.12,4.732,576254,73.1,70.6,421524,406897,14627,3.5
South Dakota,2004,306877,18796,9464,3.084,23.252,2222,10.071,1832,8.303,22259,1192,1199,5224,13766,31376,45142,14.71,4.486,23051,35678,12627,11.626,4.115,582859,73.1,70.4,425953,410618,15335,3.6
South Dakota,2005,313841,19091,5346,1.703,22.516,2199,9.812,1894,8.451,22564,1223,1242,5609,11170,29509,40679,12.962,3.559,24252,35333,11081,11.258,3.531,589510,72.8,70.2,429361,414088,15273,3.6
South Dakota,2006,322881,19300,12602,3.903,20.34,2534,11.148,2202,9.688,22896,1525,1553,6815,14962,30477,45439,14.073,4.634,22290,32837,10547,10.17,3.267,597236,72.5,70.3,432760,419816,12944,3
South Dakota,2007,329393,19435,2904,0.882,25.514,2402,10.431,2049,8.898,23204,1334,1345,6675,15429,29496,44925,13.639,4.684,29204,42021,12817,12.757,3.891,604823,72.1,70.1,436295,423910,12385,2.8
South Dakota,2008,334189,19340,7177,2.148,23.625,2168,9.344,2128,9.172,23222,1460,1474,7119,14288,32365,46653,13.96,4.275,24557,39476,14919,11.812,4.464,611461,71.8,69.6,439212,425670,13542,3.1
South Dakota,2009,334469,19219,-6772,-2.025,22.285,1927,8.302,2117,9.12,23117,1407,1417,7869,11716,25553,37269,11.143,3.503,32053,44041,11988,13.167,3.584,617610,71.5,68.2,441300,421123,20177,4.6
South Dakota,2010,330419,19229,-1633,-0.494,22.474,1977,8.529,1857,8.012,23239,1203,1212,5802,13560,23570,37130,11.237,4.104,28492,38763,10271,11.731,3.108,619307,71.6,68.1,443618,421815,21803,4.9
South Dakota,2011,327580,19116,-2945,-0.899,21.353,1907,8.211,1928,8.302,23214,1240,1281,7060,10291,24683,34974,10.676,3.142,27545,37919,10374,11.575,3.167,623838,71.5,68.2,445866,425367,20499,4.6
South Dakota,2012,330653,19245,9085,2.748,20.015,2081,8.92,1838,7.879,23450,1205,1224,5307,12952,29223,42175,12.755,3.917,23437,33090,9653,10.007,2.919,631724,70.8,67.9,447056,428943,18113,4.1
South Dakota,2013,337580,19324,5458,1.617,20.755,1954,8.309,1802,7.663,23593,1156,1164,5544,10481,30009,40490,11.994,3.105,22694,35032,12338,10.377,3.655,638676,70.1,67.5,447479,430834,16645,3.7
South Dakota,2014,343733,19366,7013,2.04,18.378,1885,7.973,1789,7.567,23690,1187,1207,5477,11208,27391,38599,11.229,3.261,22735,31586,8851,9.189,2.575,643820,70,67.7,450769,435733,15036,3.3
South Dakota,2015,349845,19598,5811,1.661,17.732,2094,8.77,1741,7.292,24052,1167,1192,6035,11437,25391,36828,10.527,3.269,21224,31017,9793,8.866,2.799,648268,69.9,67.8,453091,439293,13798,3
South Dakota,2016,355774,19770,5477,1.539,17.339,2101,8.669,1741,7.183,24417,1198,1213,5106,11137,25183,36320,10.209,3.13,23084,30843,7759,8.669,2.181,654760,69.5,67.4,455133,441418,13715,3
South Dakota,2017,358677,19792,1004,0.28,22.185,1924,7.879,1921,7.867,24421,1167,1182,6394,11563,29228,40791,11.373,3.224,27588,39787,12199,11.093,3.401,658460,69.2,67,455339,441450,13889,3.1
South Dakota,2018,359591,19880,-525,-0.146,20.607,2030,8.302,1932,7.901,24502,1232,1263,6698,11184,25867,37051,10.304,3.11,24973,37576,12603,10.45,3.505,663384,69.2,67.3,459202,446413,12789,2.8
South Dakota,2019,359364,19952,-3,-0.001,18.676,2003,8.155,1882,7.663,24621,1263,1281,5811,10662,22895,33557,9.338,2.967,24426,33560,9134,9.339,2.542,669499,69.4,67.5,464665,451735,12930,2.8
South Dakota,2020,362748,20036,5577,1.537,19.771,2163,8.752,1970,7.971,24810,1256,1317,7552,14729,26707,41436,11.423,4.06,24138,35859,11721,9.885,3.231,674169,68.9,66,464293,444895,19398,4.2
South Dakota,2021,364733,20410,-2002,-0.549,20.884,2259,9.027,1829,7.309,25239,1234,1258,5884,11625,26460,38085,10.442,3.187,29696,40087,10391,10.991,2.849,682022,68.7,67,468876,456631,12245,2.6
South Dakota,2022,367747,20799,10093,2.745,21.225,2506,9.832,1993,7.819,25745,1432,1463,5965,13716,35404,49120,13.357,3.73,27178,39027,11849,10.612,3.222,693689,68.4,67,474514,464946,9568,2
Tennessee,1978,1335173,67861,104613,7.835,25.739,11998,15.097,9303,11.706,80821,6433,6488,33150,88792,187649,276441,20.705,6.65,100150,171828,71678,12.869,5.368,3254167,60.7,57.2,1976356,1861405,114951,5.8
Tennessee,1979,1426933,69942,60946,4.271,25.959,11705,14.226,9229,11.217,83515,6603,6649,35830,80288,165865,246153,17.251,5.627,120972,185207,64235,12.979,4.502,3330417,61.2,57.6,2036959,1917893,119066,5.8
Tennessee,1980,1447744,70198,-17922,-1.238,28.144,10575,12.618,10007,11.94,84094,7327,7408,38333,70924,132806,203730,14.072,4.899,154523,221652,67129,15.31,4.637,3399000,60.9,56.5,2070888,1921618,149270,7.2
Tennessee,1981,1432332,69775,-10284,-0.718,29.007,10292,12.237,10154,12.073,84174,7547,7629,36652,78717,129023,207740,14.504,5.496,153097,218024,64927,15.222,4.533,3441750,61.4,56,2114787,1926377,188410,8.9
Tennessee,1982,1416933,68715,-23109,-1.631,30.391,10623,12.653,11129,13.255,83705,8024,8130,41566,79775,135536,215311,15.196,5.63,169448,238420,68972,16.826,4.868,3476417,61.4,54.2,2133426,1883673,249753,11.7
Tennessee,1983,1397410,69427,-18302,-1.31,31.668,11240,13.409,10986,13.106,83954,7116,7246,40646,81683,139582,221265,15.834,5.845,150583,239567,88984,17.144,6.368,3504917,62.3,55,2183143,1929318,253825,11.6
Tennessee,1984,1455560,74038,131845,9.058,22.507,14055,16.212,8630,9.954,89408,6462,6568,37376,113302,182347,295649,20.312,7.784,108883,163804,54921,11.254,3.773,3542000,62.9,57.3,2226675,2030540,196135,8.8
Tennessee,1985,1544318,75123,47673,3.087,28.929,12408,13.774,11012,12.224,90784,7850,7941,46093,92108,178940,271048,17.551,5.964,131940,223375,91435,14.464,5.921,3595667,62.6,57.7,2252329,2073593,178736,7.9
Tennessee,1986,1591238,76810,63444,3.987,28.516,12998,14.129,10531,11.447,93230,7449,7602,48603,102579,187741,290320,18.245,6.446,147040,226876,79836,14.258,5.017,3628750,63.2,58.2,2293092,2111485,181607,7.9
Tennessee,1987,1653764,78685,59613,3.605,31.635,14068,14.84,10957,11.558,96353,7630,7712,51036,127060,194135,321195,19.422,7.683,158152,261582,103430,15.817,6.254,3680250,63.3,59.1,2330559,2175012,155547,6.7
Tennessee,1988,1742695,80515,80654,4.628,31.87,14162,14.457,11192,11.425,99442,7593,7725,51612,152285,206069,358354,20.563,8.738,168698,277700,109002,15.935,6.255,3720667,62.7,59.1,2333637,2198415,135222,5.8
Tennessee,1989,1808167,82250,47075,2.603,30.313,13902,13.781,11124,11.027,102268,7748,7987,57392,120582,200545,321127,17.76,6.669,165921,274052,108131,15.156,5.98,3752583,63,59.8,2363369,2242800,120569,5.1
Tennessee,1990,1854942,83278,53911,2.906,26.575,12823,12.435,11161,10.823,103952,8006,8155,49999,111068,189314,300382,16.194,5.988,163734,246471,82737,13.287,4.46,3765396,63.7,60.3,2398216,2270895,127321,5.3
Tennessee,1991,1865849,82681,-35250,-1.889,29.812,12733,12.216,11855,11.374,104671,8285,8467,64528,112565,165561,278126,14.906,6.033,210404,313376,102972,16.795,5.519,3822509,63.3,59.1,2418517,2258759,159758,6.6
Tennessee,1992,1871561,83262,46516,2.485,28.314,12205,11.623,11434,10.889,105393,7334,7505,46705,96807,214669,311476,16.643,5.173,167930,264960,97030,14.157,5.184,3875816,63.7,59.6,2469223,2309670,159553,6.5
Tennessee,1993,1920561,85652,49045,2.554,26.799,12431,11.671,10142,9.522,107656,6694,6922,42285,99285,207109,306394,15.953,5.17,177402,257349,79947,13.4,4.163,3936541,64.4,60.6,2534515,2386930,147585,5.8
Tennessee,1994,1981990,87682,68000,3.431,25.417,12826,11.758,10239,9.386,110378,7058,7213,46366,117852,202030,319882,16.139,5.946,155971,251882,95911,12.709,4.839,4003265,66.4,63.2,2657248,2529614,127634,4.8
Tennessee,1995,2067160,90107,112746,5.454,23.101,13546,12.1,10370,9.263,113543,7151,7354,44647,122014,229504,351518,17.005,5.902,160199,238772,78573,11.551,3.801,4075573,66.8,63.4,2723127,2582870,140257,5.2
Tennessee,1996,2132935,91298,36362,1.705,27.539,13743,12.007,11101,9.698,115782,7902,8054,54602,126753,203306,330059,15.474,5.943,195061,293697,98636,13.77,4.624,4150130,66.6,63.1,2763249,2620208,143041,5.2
Tennessee,1997,2186316,91995,54135,2.476,29.607,14200,12.174,12525,10.738,117481,8410,8668,59301,130925,246857,377782,17.279,5.988,213402,323647,110245,14.803,5.043,4218938,65.9,62.4,2780642,2634225,146417,5.3
Tennessee,1998,2269209,92726,64579,2.846,27.377,13505,11.395,12107,10.215,119220,8027,8226,49091,140759,234444,375203,16.535,6.203,201170,310624,109454,13.689,4.823,4272662,65.8,62.9,2810087,2688519,121568,4.3
Tennessee,1999,2323932,92377,21991,0.946,29.194,13122,10.981,12535,10.49,119787,8189,8433,51461,129511,231699,361210,15.543,5.573,219143,339219,120076,14.597,5.167,4317553,65.8,63.2,2842999,2730146,112853,4
Tennessee,2000,2359919,91703,57035,2.417,27.404,12395,10.342,12387,10.335,119855,7989,8244,48864,119874,260516,380390,16.119,5.08,207544,323355,115811,13.702,4.907,4358399,65.4,62.8,2849026,2738785,110241,3.9
Tennessee,2001,2368500,90645,-32594,-1.376,29.709,12450,10.427,13190,11.047,119029,7955,8323,67763,124084,227748,351832,14.855,5.239,244148,384426,140278,16.231,5.923,4401204,64.9,62,2857659,2728621,129038,4.5
Tennessee,2002,2333994,90262,-60478,-2.591,31.453,13302,11.145,13561,11.362,119228,7933,8162,62015,136947,230111,367058,15.727,5.867,288413,427536,139123,18.318,5.961,4444871,65.2,61.9,2898948,2750424,148524,5.1
Tennessee,2003,2301099,90610,-4698,-0.204,30.514,12839,10.748,12321,10.315,119711,7587,7804,47683,129286,221789,351075,15.257,5.618,239158,355773,116615,15.461,5.068,4492255,64.7,61.1,2904566,2744351,160215,5.5
Tennessee,2004,2321407,92207,39828,1.716,26.264,12960,10.738,11032,9.141,121654,7079,7282,45877,114742,229928,344670,14.847,4.943,200850,304842,103992,13.132,4.48,4541581,63.8,60.4,2897792,2742911,154881,5.3
Tennessee,2005,2351449,92989,19410,0.825,26.69,13134,10.732,11700,9.56,123096,7623,7833,46873,111066,222139,333205,14.17,4.723,218592,313795,95203,13.345,4.049,4610117,62.9,59.4,2898490,2738224,160266,5.5
Tennessee,2006,2406889,94204,86993,3.614,24.057,14553,11.698,11905,9.569,125735,7799,8015,44538,135657,240849,376506,15.643,5.636,196151,289513,93362,12.029,3.879,4692392,64.2,60.9,3014749,2856079,158670,5.3
Tennessee,2007,2458528,95035,25375,1.032,29.274,14034,11.087,12307,9.723,127442,7664,7816,48339,127825,257403,385228,15.669,5.199,242525,359853,117328,14.637,4.772,4760074,63.9,61,3043258,2901946,141312,4.6
Tennessee,2008,2481705,94325,11936,0.481,28.077,12990,10.177,12534,9.819,127874,8344,8450,47573,123111,237218,360329,14.519,4.961,253387,348393,95006,14.038,3.828,4821665,63.5,59.4,3060778,2862093,198685,6.5
Tennessee,2009,2410947,91667,-166748,-6.916,21.576,10832,8.548,13784,10.877,125249,8861,9106,56681,92863,167233,260096,10.788,3.852,317409,426844,109435,17.704,4.539,4868441,62.3,56,3032658,2725134,307524,10.1
Tennessee,2010,2302315,89970,-50060,-2.174,23.358,10459,8.41,12233,9.836,123479,7674,7902,47711,89103,179786,268889,11.679,3.87,224999,318949,93950,13.853,4.081,4925390,62.8,56.6,3093118,2789056,304062,9.8
Tennessee,2011,2293990,88955,33437,1.458,22.459,10652,8.664,11749,9.556,122400,7436,7681,43041,79176,211865,291041,12.687,3.451,170462,257604,87142,11.23,3.799,4973466,62.7,57,3117492,2833278,284214,9.1
Tennessee,2012,2339701,88652,53591,2.291,21.95,10672,8.724,10806,8.834,122258,6661,6831,39922,86064,224304,310368,13.265,3.678,176592,256777,80185,10.975,3.427,5020351,61.7,56.8,3096322,2849727,246595,8
Tennessee,2013,2388475,88746,44214,1.851,22.591,10928,8.927,10516,8.59,122621,6531,6689,38711,92011,221988,313999,13.146,3.852,187186,269785,82599,11.295,3.458,5064575,60.8,56.1,3078892,2840127,238765,7.8
Tennessee,2014,2435945,88755,49305,2.024,20.39,10964,8.909,10162,8.258,123462,6430,6552,36620,92247,205398,297645,12.219,3.787,169556,248340,78784,10.195,3.234,5109856,59.6,55.6,3043573,2842540,201033,6.6
Tennessee,2015,2483816,89090,56722,2.284,20.555,11472,9.234,9923,7.987,125015,6314,6464,47030,102849,209151,312000,12.561,4.141,176019,255278,79259,10.278,3.191,5159199,59.6,56.3,3074216,2902684,171532,5.6
Tennessee,2016,2548648,90001,74416,2.92,19.445,11465,9.088,9209,7.3,127278,6082,6231,35725,103222,218982,322204,12.642,4.05,177597,247788,70191,9.722,2.754,5213936,60.2,57.3,3136399,2987679,148720,4.7
Tennessee,2017,2626021,90766,43335,1.65,23.081,11304,8.845,10226,8.002,128339,6207,6393,43850,103643,242747,346390,13.191,3.947,199278,303055,103777,11.54,3.952,5284932,60.5,58.2,3197032,3077515,119517,3.7
Tennessee,2018,2656711,91457,29624,1.115,21.304,10799,8.395,10139,7.882,128969,6214,6470,41908,91885,220732,312617,11.767,3.459,197295,282993,85698,10.652,3.226,5342696,61,58.8,3257053,3143792,113261,3.5
Tennessee,2019,2704592,92189,44730,1.654,20.205,11680,8.994,9893,7.618,130762,6521,6647,39174,104538,213423,317961,11.756,3.865,189513,273231,83718,10.102,3.095,5397378,61.9,59.8,3339445,3227700,111745,3.3
Tennessee,2020,2748552,92585,42488,1.546,21.524,11561,8.818,10863,8.285,131462,6769,6950,44115,112584,225698,338282,12.308,4.096,203467,295794,92327,10.762,3.359,5446842,60.6,56.1,3299159,3053560,245599,7.4
Tennessee,2021,2744242,94643,-51688,-1.884,24.828,13886,10.466,11428,8.613,133912,6631,7068,46777,122395,218270,340665,12.414,4.46,294306,392353,98047,14.297,3.573,5496558,60.4,57.7,3321355,3172858,148497,4.5
Tennessee,2022,2781900,96206,123045,4.423,22.654,14189,10.527,12412,9.208,135678,8122,8521,53319,128340,309808,438148,15.75,4.613,215755,315103,99348,11.327,3.571,5569973,60.4,58.3,3361979,3247975,114004,3.4
Texas,1978,4210449,226906,431745,10.254,30.434,48477,17.885,33419,12.33,278572,23326,23672,145354,389109,683331,1072440,25.471,9.242,379348,640695,261347,15.217,6.207,9535417,65.3,62.1,6228322,5922294,306028,4.9
Texas,1979,4567663,237669,306227,6.704,31.715,47468,16.624,33981,11.901,292279,24848,25168,165739,377554,652980,1030534,22.562,8.266,458383,724307,265924,15.857,5.822,9870750,65.8,62.9,6491001,6207341,283660,4.4
Texas,1980,4807120,244414,178146,3.706,32.999,46328,15.61,36922,12.441,301486,26340,26739,151836,352140,619168,971308,20.206,7.325,531343,793162,261819,16.5,5.446,10222500,66.2,62.7,6762471,6407618,354853,5.2
Texas,1981,5033554,252388,291474,5.791,30.652,50087,16.293,37507,12.201,313701,26926,27399,159192,419764,643143,1062907,21.116,8.339,510171,771433,261262,15.326,5.19,10555417,67.1,63.5,7078693,6700319,378374,5.3
Texas,1982,5325250,258708,288716,5.422,33.263,50805,15.924,40520,12.7,324191,29347,29874,181331,410159,764237,1174396,22.053,7.702,583908,885680,301772,16.632,5.667,10960167,67.2,62.5,7361339,6852398,508941,6.9
Texas,1983,5370899,268017,-241738,-4.501,36.702,53058,16.096,42277,12.826,335016,29652,30301,190328,397301,588319,985620,18.351,7.397,880658,1227358,346700,22.852,6.455,11286167,67.6,62.2,7632139,7017329,614810,8.1
Texas,1984,5386338,280275,289044,5.366,33.775,57574,16.83,43463,12.705,349137,31444,32157,192605,464791,733859,1198650,22.254,8.629,581697,909606,327909,16.887,6.088,11528417,68.3,64.1,7877566,7393901,483665,6.1
Texas,1985,5585340,283504,190358,3.408,35.695,54658,15.56,50407,14.35,353391,36812,37517,244835,461811,725403,1187214,21.256,8.268,590330,996856,406526,17.848,7.278,11752250,68.8,63.9,8082801,7514336,568465,7
Texas,1986,5659054,285053,-42120,-0.744,37.924,53789,15.13,49439,13.907,357678,35944,36659,233095,434325,638745,1073070,18.962,7.675,731624,1115190,383566,19.706,6.778,11939500,68.5,62.5,8173588,7456997,716591,8.8
Texas,1987,5528893,277893,-196594,-3.556,37.713,50854,14.332,56343,15.879,352092,39162,40127,257210,464507,578043,1042550,18.856,8.401,757570,1239144,481574,22.412,8.71,12017083,68.9,63,8275026,7571143,703883,8.5
Texas,1988,5482802,275474,60743,1.108,39.001,50435,14.326,51342,14.583,351602,35743,36806,226969,472232,657698,1129930,20.609,8.613,649124,1069187,420063,19.501,7.661,12076500,69.1,64,8350714,7730608,620106,7.4
Texas,1989,5576552,275334,143665,2.576,34.689,48425,13.756,47833,13.588,352316,32779,34122,233897,428276,682622,1110898,19.921,7.68,559138,967233,408095,17.345,7.318,12216000,69.2,64.5,8451192,7883147,568045,6.7
Texas,1990,5769185,279659,221163,3.834,31.994,48918,13.767,43013,12.106,358270,30169,31212,212638,439057,705006,1144063,19.831,7.61,561435,922900,361465,15.997,6.265,12604402,68.3,64,8610301,8061343,548958,6.4
Texas,1991,5906218,281371,63536,1.076,35.328,49896,13.826,43737,12.119,363971,29957,30929,245207,448207,658613,1106820,18.74,7.589,629673,1043284,413611,17.664,7.003,12807208,68.5,63.7,8767098,8157580,609518,7
Texas,1992,5979436,285560,31704,0.53,36.307,48480,13.235,43021,11.745,369024,27719,28614,199933,426883,690303,1117186,18.684,7.139,707045,1085482,378437,18.154,6.329,13035341,69,63.7,9000704,8308435,692269,7.7
Texas,1993,6074379,293928,158074,2.602,32.889,47894,12.857,40784,10.948,376082,26667,27585,180424,405240,751740,1156980,19.047,6.671,637262,998906,361644,16.445,5.954,13293974,69,64,9166197,8505317,660880,7.2
Texas,1994,6277752,301761,179865,2.865,30.106,50336,13.198,40810,10.7,386157,27925,28782,185800,410403,714463,1124866,17.918,6.537,609999,945001,335002,15.053,5.336,13557440,69.3,64.8,9397126,8779118,618008,6.6
Texas,1995,6510743,308861,299653,4.602,28.627,51391,13.145,41618,10.645,395843,28727,29708,189491,458251,773318,1231569,18.916,7.038,601153,931916,330763,14.314,5.08,13815490,69.3,65.1,9575849,8989910,585939,6.1
Texas,1996,6711173,313612,201036,2.996,30.636,51596,12.951,43199,10.844,402583,29868,30879,204076,475964,753106,1229070,18.314,7.092,672061,1028034,355973,15.318,5.304,14072456,69.1,65.1,9727837,9168003,559834,5.8
Texas,1997,6964671,316836,261042,3.748,33.396,53246,13.133,47864,11.806,408116,31651,32708,232909,538738,885263,1424001,20.446,7.735,724254,1162959,438705,16.698,6.299,14351589,69.1,65.4,9914827,9379863,534964,5.4
Texas,1998,7372337,322548,345122,4.681,29.806,51497,12.463,44422,10.751,416740,28749,29998,184912,511415,932389,1443804,19.584,6.937,728645,1098682,370037,14.903,5.019,14638305,69.1,65.7,10115973,9613697,502276,5
Texas,1999,7630754,323232,140627,1.843,33.109,50745,12.117,46734,11.159,420806,30352,31433,230443,484703,919142,1403845,18.397,6.352,786553,1263218,476665,16.554,6.247,14925355,68.8,65.5,10266174,9782226,483948,4.7
Texas,2000,7878530,324043,298572,3.79,29.862,49514,11.711,46126,10.91,424476,29586,30865,205857,509081,965821,1474902,18.721,6.462,750083,1176330,426247,14.931,5.41,15200557,68.3,65.3,10388337,9932973,455364,4.4
Texas,2001,8086411,325816,89293,1.104,33.642,51208,12.012,47752,11.201,428032,29112,30286,228227,545540,903959,1449499,17.925,6.746,815128,1360206,545078,16.821,6.741,15494857,68,64.6,10539140,10014830,524310,5
Texas,2002,8079007,328418,-198721,-2.46,36.665,55334,12.82,50194,11.629,434209,29630,30739,248882,636194,844908,1481102,18.333,7.875,1110630,1679823,569193,20.792,7.045,15780780,68.1,63.8,10742014,10061049,680965,6.3
Texas,2003,7986207,332340,17258,0.216,34.2,52581,12.055,48359,11.087,438298,29864,30657,214064,505273,877645,1382918,17.316,6.327,847992,1365660,517668,17.1,6.482,16050108,68,63.4,10910636,10176554,734082,6.7
Texas,2004,8045298,337327,95897,1.192,31.316,53246,12.052,46298,10.479,445276,29818,30628,208729,511631,844005,1355636,16.85,6.359,803884,1259739,455855,15.658,5.666,16322712,67.4,63.3,10998258,10336114,662144,6
Texas,2005,8188778,342160,157707,1.926,29.183,53837,11.986,46192,10.284,453005,30066,30843,204152,510313,842279,1352592,16.518,6.232,809205,1194885,385680,14.592,4.71,16623005,67.2,63.5,11172694,10561373,611321,5.5
Texas,2006,8497432,348593,430224,5.063,26.226,59833,13.024,47024,10.236,465798,30864,31646,191807,569423,975081,1544504,18.176,6.701,719813,1114280,394467,13.113,4.642,17004846,66.7,63.3,11335112,10770786,564326,5
Texas,2007,8853765,353921,268559,3.033,30.522,59730,12.698,49725,10.571,475402,30841,31565,208739,563568,1056163,1619731,18.294,6.365,866877,1351172,484295,15.261,5.47,17390495,65.8,62.9,11441054,10940176,500878,4.4
Texas,2008,9065592,356381,177181,1.954,29.428,54194,11.348,49381,10.34,479975,31637,32581,211348,525764,985347,1511111,16.669,5.8,910792,1333930,423138,14.714,4.668,17740350,65.8,62.6,11677743,11110499,567244,4.9
Texas,2009,9037823,354803,-300380,-3.324,26.675,49816,10.356,51020,10.606,480433,32864,33777,216912,454484,750942,1205426,13.338,5.029,1077448,1505806,428358,16.661,4.74,18091029,66,61,11944138,11043167,900971,7.5
Texas,2010,8832935,354525,-116983,-1.324,27.119,49181,10.221,47855,9.945,481860,30115,30906,187573,467710,730009,1197719,13.56,5.295,937700,1314702,377002,14.884,4.268,18567149,66,60.6,12260100,11255444,1004656,8.2
Texas,2011,8874507,356527,178775,2.014,25.536,51000,10.537,46702,9.649,486153,30110,30969,181251,432113,879762,1311875,14.783,4.869,791770,1133100,341330,12.768,3.846,18967568,65.9,60.6,12499595,11498869,1000726,8
Texas,2012,9150421,363404,353335,3.861,24.067,53305,10.876,45208,9.224,494171,27476,28508,181447,467492,986961,1454453,15.895,5.109,732431,1101118,368687,12.034,4.029,19328315,65.4,61,12639465,11794975,844490,6.7
Texas,2013,9490702,369540,308910,3.255,24.156,53134,10.664,44698,8.971,502468,27897,28480,178276,466421,988784,1455205,15.333,4.915,765727,1146295,380568,12.078,4.01,19686191,65.2,61.1,12832035,12022272,809763,6.3
Texas,2014,9787269,376422,275427,2.814,24.122,55305,10.888,44538,8.768,513323,28102,28825,182739,495569,960280,1455849,14.875,5.063,764855,1180422,415567,12.061,4.246,20086438,64.8,61.4,13006202,12333076,673126,5.2
Texas,2015,10100725,383039,315339,3.122,23.626,55906,10.789,46269,8.929,523008,29189,30038,189969,522352,986177,1508529,14.935,5.171,802805,1193190,390385,11.813,3.865,20509247,63.8,61,13090961,12503464,587497,4.5
Texas,2016,10356233,388856,193796,1.871,24.278,57942,10.957,46333,8.762,534614,30550,31487,202050,517203,933743,1450946,14.01,4.994,896078,1257150,361072,12.139,3.487,20905007,63.8,60.9,13346836,12728898,617938,4.6
Texas,2017,10508925,394005,153731,1.463,27.214,58035,10.791,51483,9.573,541071,31624,32722,224902,538193,1045498,1583691,15.07,5.121,948936,1429960,481024,13.607,4.577,21135080,63.8,61,13473991,12888025,585966,4.3
Texas,2018,10701000,399972,216787,2.026,24.014,56716,10.425,50318,9.249,547259,31807,32661,216634,492086,1009579,1501665,14.033,4.599,870880,1284878,413998,12.007,3.869,21443061,64,61.5,13714126,13178793,535333,3.9
Texas,2019,10965200,408116,306924,2.799,21.638,59083,10.689,48186,8.718,558190,32566,33385,213444,498765,994505,1493270,13.618,4.549,798248,1186346,388098,10.819,3.539,21776098,64,61.7,13927670,13434744,492926,3.5
Texas,2020,11187078,412566,101971,0.912,24.766,59073,10.526,52979,9.44,564274,34120,34981,222664,548347,938941,1487288,13.295,4.902,953193,1385317,432124,12.383,3.863,22132427,63,58.2,13941490,12872070,1069420,7.7
Texas,2021,11039058,424539,-413117,-3.742,24.225,67586,11.843,54799,9.603,577054,34229,35701,217914,507974,829135,1337109,12.113,4.602,1324312,1750226,425914,15.855,3.858,22486051,63.6,60,14292315,13486624,805691,5.6
Texas,2022,11174009,437470,632247,5.658,23.362,72439,12.4,57941,9.919,591418,40338,41529,243302,561402,1376100,1937502,17.339,5.024,828760,1305255,476495,11.681,4.264,22906233,64.1,61.5,14672312,14093906,578406,3.9
Utah,1978,371606,23320,45192,12.161,29.806,4985,19.207,3065,11.809,26914,2180,2212,12055,34670,65903,100573,27.064,9.33,34029,55381,21352,14.903,5.746,896750,63.5,61,569213,547137,22076,3.9
Utah,1979,408430,23943,25195,6.169,32.623,4428,16.185,3686,13.473,27729,2687,2748,14652,34596,57221,91817,22.48,8.47,41831,66622,24791,16.312,6.07,929083,65.3,62.5,606862,580223,26639,4.4
Utah,1980,424643,23899,7225,1.701,33.559,4124,14.844,4010,14.434,27839,2893,2929,16357,29833,48644,78477,18.481,7.025,44100,71252,27152,16.779,6.394,961667,65.7,61.6,632246,592629,39617,6.3
Utah,1981,436343,24176,-8610,-1.973,36.979,4576,16.245,3894,13.824,28510,2847,2886,15171,35275,45403,80678,18.49,8.084,61790,89288,27498,20.463,6.302,989583,65.6,61.2,649311,606025,43286,6.7
Utah,1982,433901,23962,3111,0.717,35.671,4226,14.787,4142,14.493,28622,2967,2996,16749,31220,49280,80500,18.553,7.195,51316,77389,26073,17.836,6.009,1016667,66,60.7,671482,617075,54407,8.1
Utah,1983,431941,24477,-7199,-1.667,37.11,4361,15.074,3764,13.01,29230,2549,2593,15308,32904,47242,80146,18.555,7.618,58990,87345,28355,20.222,6.565,1045750,66,60.1,690668,628395,62273,9
Utah,1984,444717,25452,28822,6.481,28.192,4591,15.421,3534,11.87,30300,2479,2536,14652,32502,59008,91510,20.577,7.308,36696,62688,25992,14.096,5.845,1050083,67.4,63,708004,661510,46494,6.6
Utah,1985,469037,25703,19805,4.222,30.067,4598,15.114,4345,14.282,30549,3107,3174,19325,32236,58081,90317,19.256,6.873,41356,70512,29156,15.033,6.216,1062500,69,64.8,733325,688890,44435,6.1
Utah,1986,482753,25833,7740,1.603,36.596,4633,15.073,4251,13.83,30928,2999,3050,19970,40406,55669,96075,19.902,8.37,56452,88335,31883,18.298,6.604,1076917,69.8,65.5,751868,705645,46223,6.1
Utah,1987,492881,26192,10795,2.19,36.337,4735,15.2,4281,13.743,31378,2882,2963,19185,38893,61451,100344,20.359,7.891,54947,89549,34602,18.169,7.02,1086750,69.6,65.2,755856,708535,47321,6.3
Utah,1988,506355,26353,14600,2.883,36.816,4775,15.099,4373,13.828,31825,3002,3156,24555,48962,58849,107811,21.292,9.67,52045,93211,41166,18.408,8.13,1096750,69.2,65.8,759366,721791,37575,4.9
Utah,1989,528109,26574,30009,5.682,32.588,4549,14.209,4198,13.112,32191,2879,2951,20273,45382,70678,116060,21.977,8.593,50582,86051,35469,16.294,6.716,1109833,70.9,67.6,786822,750577,36245,4.6
Utah,1990,558615,27110,28152,5.04,28.032,4336,13.327,3659,11.246,32874,2544,2614,17131,36391,70056,106447,19.056,6.515,49455,78295,28840,14.016,5.163,1159016,70.6,67.5,818663,782889,35774,4.4
Utah,1991,579179,27715,12803,2.211,31.827,4709,14.124,3684,11.05,33853,2526,2603,21403,40695,64275,104970,18.124,7.026,59115,92167,33052,15.913,5.707,1202129,70.5,67.2,847707,807483,40224,4.7
Utah,1992,601061,28562,31388,5.222,29.713,4787,13.958,3811,11.112,34784,2468,2524,19528,41227,79457,120684,20.079,6.859,55138,89296,34158,14.856,5.683,1250594,70.6,67.1,882385,839427,42958,4.9
Utah,1993,634020,29880,35098,5.536,25.632,4897,13.823,3594,10.145,36079,2413,2520,19125,37196,79158,116354,18.352,5.867,49315,81256,31941,12.816,5.038,1303475,71.9,69,936996,899145,37851,4
Utah,1994,673095,31512,40376,5.999,25.5,5663,15.26,3724,10.035,38079,2635,2712,20508,44246,81948,126194,18.748,6.574,53427,85818,32391,12.75,4.812,1357272,73.3,70.6,995192,958082,37110,3.7
Utah,1995,716829,33112,48738,6.799,25.544,5882,15.066,3940,10.092,40012,2805,2877,19491,54035,86257,140292,19.571,7.538,61331,91554,30223,12.772,4.216,1406487,72.4,69.9,1018732,983632,35100,3.4
Utah,1996,754234,34617,35605,4.721,27.12,6175,15.126,4265,10.448,41778,3040,3114,22211,55836,82045,137881,18.281,7.403,68172,102276,34104,13.56,4.522,1452951,71.7,69.3,1041955,1006743,35212,3.4
Utah,1997,797012,35980,47436,5.952,31.005,6527,15.317,4918,11.541,43418,3294,3386,23838,65443,105549,170992,21.454,8.211,74387,123556,49169,15.502,6.169,1491332,71.7,69.5,1069942,1036174,33768,3.2
Utah,1998,835717,37099,18063,2.161,33.058,6265,14.182,5003,11.325,44808,3319,3369,22330,57550,98647,156197,18.69,6.886,97637,138134,40497,16.529,4.846,1524880,72.4,69.8,1103543,1064134,39409,3.6
Utah,1999,870805,38112,21033,2.415,30.276,6777,14.846,5112,11.199,46480,3475,3576,29259,58939,93916,152855,17.553,6.768,82201,131822,49621,15.138,5.698,1554094,72.3,69.8,1123871,1084452,39419,3.5
Utah,2000,895522,38857,28020,3.129,28.814,6538,13.872,5267,11.175,47768,3548,3628,25414,57526,99512,157038,17.536,6.424,83848,129018,45170,14.407,5.044,1583059,72.2,69.8,1142860,1104750,38110,3.3
Utah,2001,911209,39835,-3367,-0.37,35.481,7031,14.567,6137,12.714,48715,3623,3719,29498,61572,100083,161655,17.741,6.757,99123,165022,65899,18.11,7.232,1620083,71.8,68.6,1162874,1112047,50827,4.4
Utah,2002,908825,40808,-6886,-0.758,36.356,7558,15.295,6314,12.777,50037,3696,3769,29969,65804,99401,165205,18.178,7.241,115387,172091,56704,18.936,6.239,1655613,71.2,67.2,1179433,1112581,66852,5.7
Utah,2003,901742,42296,-3389,-0.376,34.043,7739,15.242,6237,12.284,51526,3906,3984,30221,63048,90443,153491,17.022,6.992,96944,156880,59936,17.397,6.647,1689212,70.9,66.9,1197252,1130789,66463,5.6
Utah,2004,905005,44037,15490,1.712,33.036,7930,15.105,6010,11.448,53460,3838,3883,23699,65340,99637,164977,18.229,7.22,84153,149487,65334,16.518,7.219,1730928,71.2,67.6,1231740,1170046,61694,5
Utah,2005,935106,45960,44757,4.786,28.06,8365,15.336,6209,11.383,55623,3976,4054,24941,60592,115362,175954,18.816,6.48,82222,131197,48975,14.03,5.237,1777777,72,69.1,1280653,1228827,51826,4
Utah,2006,990968,48938,65122,6.572,24.306,9793,17.047,6145,10.697,59272,4121,4213,23939,66697,118858,185555,18.725,6.73,80724,120433,39709,12.153,4.007,1835540,72.6,70.6,1333278,1295285,37993,2.8
Utah,2007,1061973,51521,52093,4.905,27.567,9675,15.931,6733,11.087,62200,4410,4435,25687,62859,135613,198472,18.689,5.919,94038,146379,52341,13.784,4.929,1889476,72.9,71,1377638,1342237,35401,2.6
Utah,2008,1093147,51625,12367,1.131,31.41,8286,13.28,7862,12.601,62605,5365,5422,29725,58328,125716,184044,16.836,5.336,111031,171677,60646,15.705,5.548,1934013,71.6,69.3,1385646,1339394,46252,3.3
Utah,2009,1072143,49474,-55902,-5.214,26.242,7027,11.38,9258,14.993,60635,6191,6261,37311,50461,90213,140674,13.121,4.707,137945,196576,58631,18.335,5.469,1972474,69.7,64.6,1373841,1274210,99631,7.3
Utah,2010,1023819,48799,-39506,-3.859,25.219,7316,12.131,8011,13.283,59962,5073,5208,28617,50964,78132,129096,12.609,4.978,118676,168602,49926,16.468,4.876,1970916,68.5,63.1,1350173,1242907,107266,7.9
Utah,2011,1009542,48847,9901,0.981,25.317,7308,12.168,7098,11.818,60165,4441,4545,24567,46418,91274,137692,13.639,4.598,87348,127791,40443,12.658,4.006,1991465,67.4,62.6,1341427,1246797,94630,7.1
Utah,2012,1033814,49807,38615,3.735,22.884,7621,12.547,6465,10.644,61319,4070,4162,22856,48084,108821,156905,15.177,4.651,81246,118290,37044,11.442,3.583,2025840,66.6,63.4,1348557,1284149,64408,4.8
Utah,2013,1070914,50887,37318,3.485,22.85,7510,12.117,6146,9.916,62663,3761,3808,22058,56756,102913,159669,14.91,5.3,80085,122351,42266,11.425,3.947,2063005,67.2,64.4,1385908,1327560,58348,4.2
Utah,2014,1117586,52128,42658,3.817,22.272,7620,12.016,6132,9.669,64162,3882,3943,22417,57072,110043,167115,14.953,5.107,84384,124457,40073,11.136,3.586,2099304,67.4,65,1415779,1364353,51426,3.6
Utah,2015,1171705,53325,54024,4.611,21.948,7919,12.181,6238,9.596,65849,3999,4093,23499,60730,121879,182609,15.585,5.183,88482,128585,40103,10.974,3.423,2140901,67.9,65.5,1453457,1401945,51512,3.5
Utah,2016,1221592,54521,43618,3.571,21.016,8042,12.048,6250,9.363,67646,4028,4116,25454,54148,117833,171981,14.078,4.433,85501,128363,42862,10.508,3.509,2193627,68.4,66.1,1500137,1449981,50156,3.3
Utah,2017,1260906,55796,40650,3.224,22.428,8047,11.774,6630,9.701,69055,4057,4129,26083,57137,124914,182051,14.438,4.531,92113,141401,49288,11.214,3.909,2260156,68.8,66.6,1554352,1505413,48939,3.1
Utah,2018,1309887,57513,53250,4.065,20.525,8278,11.846,6596,9.439,70720,4044,4104,28181,58414,129262,187676,14.328,4.459,84453,134426,49973,10.262,3.815,2312734,68.5,66.5,1584494,1538295,46199,2.9
Utah,2019,1354731,59095,36991,2.731,20.039,8453,11.807,6736,9.408,72454,4536,4599,27450,55299,117428,172727,12.75,4.082,92335,135736,43401,10.019,3.204,2365223,68.5,66.7,1619079,1577970,41109,2.5
Utah,2020,1390363,60355,30425,2.188,22.759,8908,12.164,7348,10.034,74012,4679,4752,33021,58939,129700,188639,13.568,4.239,104882,158214,53332,11.379,3.836,2418042,68,64.7,1644201,1564747,79454,4.8
Utah,2021,1426139,64034,39248,2.752,24.465,10732,14.134,6907,9.097,77842,4535,4596,28701,67165,146537,213702,14.985,4.71,128074,174454,46380,12.233,3.252,2475989,68,66.1,1683325,1636957,46368,2.8
Utah,2022,1482765,66183,73808,4.978,23.829,10843,13.715,8378,10.597,80292,6071,6184,36347,79630,170844,250474,16.892,5.37,111608,176666,65058,11.915,4.388,2526652,68.8,67.1,1737741,1696513,41228,2.4
Vermont,1978,151959,10895,12400,8.16,28.115,1870,15.96,1138,9.712,12083,844,852,7972,10863,22899,33762,22.218,7.149,10526,21362,10836,14.058,7.131,359833,66.2,62.4,238051,224572,13479,5.7
Vermont,1979,162077,11364,7247,4.471,24.522,1727,13.975,1219,9.864,12612,928,931,4550,9135,17984,27119,16.732,5.636,13092,19872,6780,12.261,4.183,368667,66.2,62.9,244152,231997,12155,5
Vermont,1980,166259,11544,1023,0.615,28.026,1571,12.351,1364,10.724,12823,1049,1055,4064,7340,16981,24321,14.628,4.415,16905,23298,6393,14.013,3.845,376667,66.2,62.3,249412,234664,14748,5.9
Vermont,1981,167900,11592,3484,2.075,25.256,1508,11.722,1410,10.96,12914,1030,1037,4253,7054,17632,24686,14.703,4.201,15094,21202,6108,12.628,3.638,381833,67.4,63.5,257421,242372,15049,5.8
Vermont,1982,168547,11701,-2074,-1.231,26.345,1628,12.539,1486,11.446,13054,1089,1094,4477,7940,14262,22202,13.173,4.711,16372,24276,7904,14.403,4.689,386750,67.9,63.3,262770,244817,17953,6.8
Vermont,1983,167382,11855,-1077,-0.643,27.251,1657,12.623,1467,11.175,13222,1038,1043,4127,8085,14722,22807,13.626,4.83,17502,23884,6382,14.269,3.813,391667,67.9,63.4,265881,248510,17371,6.5
Vermont,1984,172410,12770,10348,6.002,22.136,2134,15.576,1194,8.715,14171,870,876,3990,10137,19293,29430,17.07,5.88,12707,19082,6375,11.068,3.698,396167,68.3,65,270746,257479,13267,4.9
Vermont,1985,179820,13276,4968,2.763,27.433,2134,14.793,1611,11.168,14687,1184,1203,5565,10606,19027,29633,16.479,5.898,14350,24665,10315,13.717,5.736,401750,69.5,66.3,279312,266490,12822,4.6
Vermont,1986,186851,13736,9725,5.205,26.704,2309,15.424,1724,11.516,15263,1277,1285,6145,13561,21112,34673,18.557,7.258,15972,24948,8976,13.352,4.804,407000,70.9,67.8,288437,275951,12486,4.3
Vermont,1987,199528,14503,14581,7.308,26.357,2501,15.92,1616,10.287,16152,1165,1173,6157,16954,23922,40876,20.486,8.497,15687,26295,10608,13.179,5.317,413250,71.4,68.7,294972,283914,11058,3.7
Vermont,1988,208765,15188,4317,2.068,31.589,2490,15.053,1740,10.519,16917,1272,1285,7242,15375,21915,37290,17.862,7.365,21002,32973,11971,15.794,5.734,422250,70.8,68.7,299107,290082,9025,3
Vermont,1989,215622,15758,9303,4.314,24.127,2497,14.464,1833,10.617,17596,1418,1435,7221,12795,22520,35315,16.378,5.934,16269,26012,9743,12.064,4.519,429750,70.9,68.4,304811,293748,11063,3.6
Vermont,1990,217709,15780,-4609,-2.117,27.513,2060,11.681,2005,11.369,17663,1552,1564,7110,10385,19564,29949,13.756,4.77,23453,34558,11105,15.873,5.101,429402,71.5,68.1,307008,292550,14458,4.7
Vermont,1991,209937,15415,-10436,-4.971,25.461,1849,10.538,2077,11.837,17432,1539,1547,8285,11541,15185,26726,12.73,5.497,25268,37162,11894,17.702,5.666,432368,70.9,66.7,306688,288513,18175,5.9
Vermont,1992,205606,15282,-448,-0.218,28.764,1778,10.24,1892,10.897,17306,1296,1304,6531,9847,19723,29570,14.382,4.789,20378,30018,9640,14.6,4.689,434827,71.7,67.2,311658,292223,19435,6.2
Vermont,1993,207024,15580,4655,2.249,25.981,1950,11.165,1618,9.264,17632,1165,1191,4918,10142,21406,31548,15.239,4.899,16062,26893,10831,12.99,5.232,438619,71.7,67.9,314369,298015,16354,5.2
Vermont,1994,211380,15799,3351,1.585,24.73,1822,10.251,1579,8.884,17896,1119,1139,4956,9379,20109,29488,13.95,4.437,17127,26137,9010,12.365,4.262,443078,71.3,68.1,315892,301923,13969,4.4
Vermont,1995,215987,16090,5549,2.569,24.649,1877,10.391,1555,8.608,18225,1121,1131,6410,11288,20880,32168,14.893,5.226,16102,26619,10517,12.324,4.869,448121,71.4,68.4,319872,306565,13307,4.2
Vermont,1996,218970,16136,3363,1.536,25.604,1887,10.335,1701,9.316,18351,1244,1265,6548,11655,19741,31396,14.338,5.323,16759,28033,11274,12.802,5.149,453496,71.8,68.7,325484,311503,13981,4.3
Vermont,1997,223657,16333,6364,2.845,25.344,2012,10.9,1800,9.751,18565,1263,1276,6221,15183,19523,34706,15.518,6.789,17743,28342,10599,12.672,4.739,458789,71.9,69.1,330073,317059,13014,3.9
Vermont,1998,232770,16485,8588,3.689,22.28,1844,9.892,1798,9.645,18664,1224,1252,5172,10474,24045,34519,14.83,4.5,16995,25931,8936,11.14,3.839,463498,72.1,69.6,334359,322792,11567,3.5
Vermont,1999,240124,16707,5369,2.236,22.787,1924,10.207,1568,8.318,19028,1148,1167,5970,10561,22167,32728,13.63,4.398,18375,27359,8984,11.394,3.741,468457,72,69.8,337468,327099,10369,3.1
Vermont,2000,247704,16765,9767,3.943,22.331,1795,9.398,1686,8.827,19155,1199,1209,5211,12182,25242,37424,15.108,4.918,19035,27657,8622,11.165,3.481,473915,70.5,68.5,334055,324667,9388,2.8
Vermont,2001,251160,16650,3802,1.514,22.806,1668,8.735,1660,8.693,19100,1154,1168,5660,10407,22035,32442,12.917,4.144,18580,28640,10060,11.403,4.005,478732,70.6,68.3,338145,326980,11165,3.3
Vermont,2002,255524,16557,-2421,-0.947,29.448,1839,9.607,1962,10.25,19080,1173,1199,6400,14327,23296,37623,14.724,5.607,26664,40044,13380,15.671,5.236,483460,71,68.3,343261,330080,13181,3.8
Vermont,2003,253320,16653,-1927,-0.761,26.696,1876,9.787,1671,8.717,19271,1056,1079,6375,10620,23193,33813,13.348,4.192,22660,35740,13080,14.109,5.163,487922,71,67.9,346380,331239,15141,4.4
Vermont,2004,253269,16916,260,0.103,22.229,1859,9.579,1589,8.187,19543,1040,1053,4681,10335,18075,28410,11.217,4.081,19918,28150,8232,11.115,3.25,491813,70.6,68,347352,334555,12797,3.7
Vermont,2005,256330,17020,5414,2.112,22.026,1825,9.298,1680,8.559,19700,1107,1119,5552,10619,23024,33643,13.125,4.143,19214,28229,9015,11.013,3.517,495490,70.5,68.1,349521,337407,12114,3.5
Vermont,2006,260720,17108,3244,1.244,21.042,1992,10.062,1786,9.022,19900,1269,1281,5248,9751,20923,30674,11.765,3.74,19074,27430,8356,10.521,3.205,499415,71.2,68.5,355394,342232,13162,3.7
Vermont,2007,262040,17166,-377,-0.144,24.737,1965,9.862,1887,9.471,19964,1172,1182,4899,10534,21876,32410,12.368,4.02,22042,32787,10745,12.512,4.101,502287,70.3,67.6,353268,339367,13901,3.9
Vermont,2008,261760,16885,548,0.209,23.649,1697,8.564,1948,9.831,19689,1247,1256,6328,11269,20231,31500,12.034,4.305,20381,30952,10571,11.825,4.038,504718,70.1,67,353986,337925,16061,4.5
Vermont,2009,259276,16391,-7822,-3.017,21.842,1532,7.851,2033,10.418,19264,1255,1272,6233,11287,17028,28315,10.921,4.353,25465,36137,10672,13.938,4.116,507164,70.8,66.5,359282,337018,22264,6.2
Vermont,2010,255311,16223,-955,-0.374,20.783,1513,7.882,1675,8.726,19114,1044,1052,4382,9296,17234,26530,10.391,3.641,20366,27485,7119,10.765,2.788,507845,70.8,66.3,359692,336920,22772,6.3
Vermont,2011,255071,16051,875,0.343,20.569,1553,8.169,1759,9.253,18907,1121,1142,4724,7151,19957,27108,10.628,2.804,17896,26233,8337,10.285,3.269,510272,70.1,66.2,357676,337779,19897,5.6
Vermont,2012,260873,16073,10783,4.133,20.13,1677,8.856,1613,8.518,18969,1027,1053,5057,9757,27283,37040,14.199,3.74,17894,26257,8363,10.065,3.206,511492,69.2,65.9,353947,336899,17048,4.8
Vermont,2013,260825,15947,-7772,-2.98,21.5,1446,7.646,1534,8.111,18868,968,968,13733,7723,20316,28039,10.75,2.961,18567,35811,17244,13.73,6.611,512771,68.3,65.3,350175,334684,15491,4.4
Vermont,2014,259113,15933,2585,0.998,19.216,1516,8.032,1516,8.032,18874,959,994,5482,7619,19861,27480,10.605,2.94,16989,24895,7906,9.608,3.051,513649,67.9,65.2,348697,334742,13955,4
Vermont,2015,263096,15995,5500,2.09,17.408,1507,7.955,1368,7.221,19014,924,935,3999,8483,19917,28400,10.795,3.224,16635,22900,6265,8.704,2.381,514884,67.3,64.9,346512,334262,12250,3.5
Vermont,2016,266681,16005,1205,0.452,19.061,1505,7.896,1418,7.44,19103,921,933,4005,7602,19019,26621,9.982,2.851,18579,25416,6837,9.531,2.564,515410,67.1,65,345851,335043,10808,3.1
Vermont,2017,260272,15943,-1731,-0.665,22.207,1464,7.682,1538,8.07,19021,988,998,4823,8033,20866,28899,11.103,3.086,21600,30630,9030,11.768,3.469,527814,67.3,65.3,355385,344698,10687,3
Vermont,2018,260560,15879,2684,1.03,19.076,1392,7.337,1466,7.727,18936,947,959,4909,8693,18843,27536,10.568,3.336,16575,24852,8277,9.538,3.177,530176,67,65.4,355343,346553,8790,2.5
Vermont,2019,261815,15763,-1482,-0.566,18.304,1399,7.405,1487,7.871,18848,1035,1043,5046,7651,16310,23961,9.152,2.922,17221,25443,8222,9.718,3.14,532459,66.4,65,353432,346059,7373,2.1
Vermont,2020,259353,15586,-2947,-1.136,18.824,1405,7.492,1593,8.495,18659,1034,1041,5198,6980,17430,24410,9.412,2.691,18501,27357,8856,10.548,3.415,534621,63.6,60,339758,320708,19050,5.6
Vermont,2021,248707,15346,-18293,-7.355,18.783,1555,8.398,1842,9.948,18372,1103,1135,4511,8164,15193,23357,9.391,3.283,33125,41650,8525,16.747,3.428,538623,62.4,60.2,336265,324166,12099,3.6
Vermont,2022,246338,15758,13869,5.63,19.205,1984,10.702,1633,8.809,18714,1031,1060,4835,8926,28597,37523,15.232,3.623,14446,23654,9208,9.602,3.738,540466,63.6,62.1,343550,335547,8003,2.3
Virginia,1978,1446526,76524,110166,7.616,26.915,13594,14.961,9526,10.484,92897,6307,6402,34613,99032,205803,304835,21.074,6.846,120067,194669,74602,13.458,5.157,3755667,66.2,62.7,2485923,2354830,131093,5.3
Virginia,1979,1553291,79697,95490,6.148,25.06,12961,13.646,9329,9.822,96796,6615,6682,32487,90952,199166,290118,18.678,5.855,132326,194628,62302,12.53,4.011,3824750,66.2,63.1,2531430,2411522,119908,4.7
Virginia,1980,1617245,80548,32391,2.003,26.677,11989,12.303,10649,10.928,98121,7616,7699,34845,80338,167766,248104,15.341,4.968,152308,215713,63405,13.338,3.921,3888500,65.9,62.6,2563744,2433183,130561,5.1
Virginia,1981,1649437,81021,32357,1.962,27.316,12303,12.453,10833,10.965,99532,7773,7926,38227,107345,150290,257635,15.62,6.508,154657,225278,70621,13.658,4.282,3958750,66,62,2610962,2455453,155509,6
Virginia,1982,1658404,80492,-6350,-0.383,30.105,12052,12.082,11784,11.814,99884,8283,8403,43087,90063,159569,249632,15.053,5.431,179511,255982,76471,15.435,4.611,4019500,66.4,61.5,2668646,2470570,198076,7.4
Virginia,1983,1652655,82867,9142,0.553,30.25,13137,12.974,10387,10.258,102629,7053,7233,39544,85847,173261,259108,15.678,5.194,171769,249966,78197,15.125,4.732,4082000,66.8,62.6,2728372,2555773,172599,6.3
Virginia,1984,1717761,88177,127818,7.441,22.903,16271,15.396,10340,9.784,108651,7539,7642,41617,112468,212061,324529,18.893,6.547,121266,196711,75445,11.452,4.392,4152917,67.7,64.2,2809612,2667055,142557,5.1
Virginia,1985,1830955,90906,99359,5.427,26.228,16585,15.038,13354,12.108,111902,9931,10082,61027,118387,221081,339468,18.54,6.466,139422,240109,100687,13.114,5.499,4214167,68,64.3,2866064,2710875,155189,5.4
Virginia,1986,1938164,94932,123035,6.348,25.439,17000,14.826,11412,9.953,117454,7919,8028,44477,142843,226716,369559,19.067,7.37,165422,246524,81102,12.719,4.184,4299250,67.9,64.5,2918476,2773994,144482,5
Virginia,1987,2061508,98255,111153,5.392,29.4,18171,15.133,12931,10.769,122692,8845,8979,56943,164727,249465,414192,20.092,7.991,193040,303039,109999,14.7,5.336,4394833,68.3,65.5,3003631,2878319,125312,4.2
Virginia,1988,2161792,102393,92572,4.282,29.893,18662,14.86,13203,10.513,128318,8983,9152,55259,167823,247857,415680,19.228,7.763,209234,323108,113874,14.946,5.268,4480667,68.8,66.1,3083608,2963334,120274,3.9
Virginia,1989,2255546,105497,79537,3.526,28.628,18674,14.285,13961,10.68,133077,9673,9939,57817,158342,244054,402396,17.84,7.02,203829,322859,119030,14.314,5.277,4545667,69.2,66.5,3143399,3021188,122211,3.9
Virginia,1990,2325447,108007,57185,2.459,28.275,17857,13.231,14116,10.46,136829,9956,10153,58025,145710,240231,385941,16.596,6.266,225785,328756,102971,14.137,4.428,4655613,69.5,66.4,3233668,3091035,142633,4.4
Virginia,1991,2299617,106479,-100209,-4.358,28.493,16637,12.166,16477,12.049,136827,11185,11547,76041,143427,184187,327614,14.246,6.237,295564,427823,132259,18.604,5.751,4714028,70.4,66.4,3320497,3128385,192112,5.8
Virginia,1992,2256005,107024,14257,0.632,30.598,15933,11.629,15271,11.145,137346,9545,9838,56300,127718,231680,359398,15.931,5.661,228073,345141,117068,15.299,5.189,4780310,70.6,66.3,3376927,3168136,208791,6.2
Virginia,1993,2286535,109691,46464,2.032,27.687,15816,11.419,13458,9.717,139683,8575,8854,47994,125279,237724,363003,15.876,5.479,213479,316539,103060,13.844,4.507,4853592,69.4,65.8,3370301,3195929,174372,5.2
Virginia,1994,2349219,112390,58747,2.501,26.159,16334,11.553,13333,9.43,142886,8797,9022,49576,128046,237972,366018,15.58,5.451,206013,307271,101258,13.08,4.31,4918957,69.4,66.1,3415048,3250198,164850,4.8
Virginia,1995,2427644,115798,91192,3.756,25.088,17421,12.022,13376,9.23,146935,9042,9313,53060,140852,254861,395713,16.3,5.802,196744,304521,107777,12.544,4.44,4982739,69.2,66.1,3447155,3293865,153290,4.4
Virginia,1996,2480655,116804,39348,1.586,28.362,16953,11.487,14519,9.838,148801,9852,10152,55811,143828,247296,391124,15.767,5.798,239472,351776,112304,14.181,4.527,5052520,68.1,65.1,3438841,3289651,149190,4.3
Virginia,1997,2554804,118969,110084,4.309,28.209,18548,12.345,15701,10.45,151675,9840,10249,61906,160114,310310,470424,18.413,6.267,228350,360340,131990,14.104,5.166,5116552,67.7,65.2,3464890,3336527,128363,3.7
Virginia,1998,2667332,121254,77627,2.91,27.271,18088,11.762,14840,9.65,155404,9364,9684,57342,162345,278988,441333,16.546,6.086,236775,363706,126931,13.636,4.759,5171501,67.7,65.8,3499842,3402386,97456,2.8
Virginia,1999,2742044,121986,68394,2.494,27.33,16961,10.882,16027,10.283,156328,9583,9916,59954,150832,292263,443095,16.159,5.501,244597,374701,130104,13.665,4.745,5240616,67.8,66,3555130,3459203,95927,2.7
Virginia,2000,2847443,122981,117731,4.135,26.412,17159,10.903,15292,9.717,158313,9476,9787,56638,168564,325200,493764,17.341,5.92,241152,376033,134881,13.206,4.737,5304549,68,66.4,3606390,3524481,81909,2.3
Virginia,2001,2920804,123927,23707,0.812,30.766,17326,10.904,16006,10.074,159549,9369,9742,61367,175257,297753,473010,16.195,6,298963,449303,150340,15.383,5.147,5379278,68.4,66.2,3681107,3559669,121438,3.3
Virginia,2002,2938568,125302,-31681,-1.078,33.22,19200,11.92,17096,10.614,162124,9691,10019,80874,194778,293325,488103,16.61,6.628,335732,519784,184052,17.688,6.263,5453731,68.6,65.6,3739499,3576530,162969,4.4
Virginia,2003,2925539,127410,7550,0.258,29.615,18639,11.411,16082,9.846,164616,9489,9806,58031,150179,290573,440752,15.066,5.133,283429,433202,149773,14.808,5.12,5518252,68.4,65.4,3772549,3609335,163214,4.3
Virginia,2004,2988345,131585,108899,3.644,24.876,19712,11.793,14707,8.798,169658,9133,9300,54782,158122,322464,480586,16.082,5.291,252177,371687,119510,12.438,3.999,5615773,67.9,65.1,3814529,3658421,156108,4.1
Virginia,2005,3053460,134710,28379,0.929,27.401,19816,11.552,16135,9.406,173383,10084,10373,56319,157907,288816,446723,14.63,5.171,288923,418344,129421,13.701,4.239,5705956,68.5,65.8,3906549,3756587,149962,3.8
Virginia,2006,3138351,138304,118469,3.775,25.14,22468,12.738,16442,9.322,179397,10937,11109,61663,183001,329958,512959,16.345,5.831,269583,394490,124907,12.57,3.98,5788571,68.7,66.4,3976503,3844285,132218,3.3
Virginia,2007,3193769,139563,-7337,-0.23,30.913,21052,11.652,18425,10.198,181980,11417,11577,70052,171863,321782,493645,15.457,5.381,344017,500982,156965,15.686,4.915,5857950,69,66.7,4039414,3906626,132788,3.3
Virginia,2008,3180929,138275,-14877,-0.468,28.208,18191,10.04,19600,10.818,180477,12330,12538,63341,138551,310094,448645,14.104,4.356,306487,463522,157035,14.572,4.937,5926737,69.7,66.7,4128589,3952723,175866,4.3
Virginia,2009,3118354,134811,-126687,-4.063,23.927,17021,9.473,19883,11.066,178244,12777,13007,72506,149680,223382,373062,11.963,4.8,356308,499749,143441,16.026,4.6,6000845,68.9,64.2,4136186,3853351,282835,6.8
Virginia,2010,3032197,133097,-53908,-1.778,24.385,16430,9.262,18236,10.28,176485,10824,11167,63271,126737,242970,369707,12.193,4.18,282685,423615,140930,13.971,4.648,6144283,67.8,62.8,4163293,3858466,304827,7.3
Virginia,2011,3022026,132223,28524,0.944,24.428,17347,9.832,17455,9.894,176373,10726,11036,53648,127173,270455,397628,13.158,4.208,258777,369104,110327,12.214,3.651,6243509,67.4,62.9,4205184,3929008,276176,6.6
Virginia,2012,3064694,132825,53381,1.742,24.965,16635,9.422,16215,9.184,176765,9480,9747,49509,120480,315446,435926,14.224,3.931,267609,382545,114936,12.482,3.75,6319657,66.7,62.8,4217529,3967151,250378,5.9
Virginia,2013,3099455,133226,30563,0.986,24.565,16998,9.593,16052,9.059,177663,9274,9444,51768,133251,277995,411246,13.268,4.299,260332,380683,120351,12.282,3.883,6383104,66.4,62.7,4238377,4002057,236320,5.6
Virginia,2014,3127158,133650,30356,0.971,23.038,16835,9.435,15336,8.595,179175,9520,9675,45775,129973,260598,390571,12.49,4.156,254113,360215,106102,11.519,3.393,6441177,66.1,62.7,4258856,4040908,217948,5.1
Virginia,2015,3181125,134682,58314,1.833,22.101,17169,9.538,15546,8.636,180825,9324,9512,48978,142733,267118,409851,12.884,4.487,240327,351537,111210,11.051,3.496,6495053,65.2,62.3,4233981,4048081,185900,4.4
Virginia,2016,3243596,135928,56232,1.734,21.812,17528,9.62,14798,8.121,183573,9332,9570,50542,133712,276262,409974,12.639,4.122,252246,353742,101496,10.906,3.129,6543548,65,62.4,4254348,4084822,169526,4
Virginia,2017,3286037,136824,43873,1.335,22.883,16656,9.053,15832,8.606,184387,9533,9744,55161,120583,299262,419845,12.777,3.67,253518,375972,122454,11.442,3.726,6624960,65.7,63.3,4352977,4193290,159687,3.7
Virginia,2018,3346881,137353,74146,2.215,20.976,16275,8.822,15969,8.656,184629,9600,9822,53520,124233,300929,425162,12.703,3.712,243227,351016,107789,10.488,3.221,6670343,65.3,63.4,4359053,4228274,130779,3
Virginia,2019,3426374,138745,74486,2.174,19.735,16849,9.071,14620,7.871,186870,9773,9913,58199,122439,290150,412589,12.042,3.573,234915,338103,103188,9.868,3.012,6718931,65.8,64,4419378,4297265,122113,2.8
Virginia,2020,3476211,138628,22950,0.66,22.306,16459,8.807,16469,8.813,186875,10160,10389,56331,128295,282360,410655,11.813,3.691,264580,387705,123125,11.153,3.542,6753190,64.2,60,4332338,4053387,278951,6.4
Virginia,2021,3422525,140663,-131379,-3.839,23.415,18767,10.027,18187,9.717,187450,10206,10551,52980,130458,270233,400691,11.707,3.812,396843,532070,135227,15.546,3.951,6782037,63.6,61.2,4315045,4148175,166870,3.9
Virginia,2022,3423726,142867,134763,3.936,22.645,20122,10.682,18223,9.674,189321,11796,12099,66994,141096,381325,522421,15.259,4.121,249366,387658,138292,11.323,4.039,6816033,65,63.2,4427292,4304759,122533,2.8
Washington,1978,1083488,71763,132707,12.248,26.53,15065,18.578,8922,11.003,84161,6255,6329,32982,86382,190050,276432,25.513,7.973,86142,143725,57583,13.265,5.315,2823333,64.1,59.8,1810817,1687119,123698,6.8
Washington,1979,1180552,75681,101946,8.635,28.892,13983,16.173,9946,11.504,88475,6938,7031,35010,86128,186363,272491,23.082,7.296,109073,170545,61472,14.446,5.207,2940250,65.3,60.9,1921362,1790981,130381,6.8
Washington,1980,1248471,76490,38130,3.054,32.956,13122,14.723,11758,13.192,89810,8439,8539,45822,85431,158423,243854,19.532,6.843,135184,205724,70540,16.478,5.65,3056083,64.5,59.4,1970361,1814249,156112,7.9
Washington,1981,1272949,77193,12554,0.986,33.7,12925,14.281,11477,12.681,91230,8269,8359,40955,88166,138881,227047,17.836,6.926,150524,214493,63969,16.85,5.025,3121583,64.3,58.3,2006646,1819243,187403,9.3
Washington,1982,1250854,76432,-31741,-2.538,33.718,12651,13.868,12785,14.015,91155,8870,8951,44633,79231,131652,210883,16.859,6.334,170719,242624,71905,19.397,5.748,3158000,64.1,56.6,2024630,1788779,235851,11.6
Washington,1983,1229037,79028,-12747,-1.037,35.033,13928,15.058,11209,12.118,93857,7535,7702,41301,78981,136305,215286,17.517,6.426,158091,228033,69942,18.554,5.691,3186750,64.3,57.1,2048647,1819782,228865,11.2
Washington,1984,1280489,83925,58465,4.566,30.525,15418,15.982,10292,10.668,99037,7335,7410,35916,89978,163923,253901,19.828,7.027,125414,195436,70022,15.263,5.468,3226083,64.4,58.4,2076526,1883475,193051,9.3
Washington,1985,1327678,85121,31461,2.37,32.331,14496,14.539,13197,13.236,100352,9251,9412,50701,85872,160212,246084,18.535,6.468,132140,214623,82483,16.165,6.213,3258750,64.7,59.3,2107564,1933767,173797,8.2
Washington,1986,1374567,87146,61905,4.504,32.206,15533,15.27,12769,12.553,103103,8948,9095,49271,101228,182024,283252,20.607,7.364,138701,221347,82646,16.103,6.013,3328417,65.6,60.3,2184947,2007967,176980,8.1
Washington,1987,1416671,89020,74362,5.249,32.328,15949,15.273,13274,12.711,105765,9194,9343,50599,115966,187384,303350,21.413,8.186,139659,228988,89329,16.164,6.306,3398750,66.5,61.7,2261466,2096604,164862,7.3
Washington,1988,1487186,91478,63156,4.247,34.023,16064,14.948,12985,12.083,109002,8663,8874,51424,111805,204344,316149,21.258,7.518,153832,252993,99161,17.012,6.668,3477250,67.1,62.9,2334006,2187896,146110,6.3
Washington,1989,1573735,94008,105439,6.7,28.627,16223,14.65,12852,11.606,112422,8847,8999,51754,116657,214035,330692,21.013,7.413,142099,225253,83154,14.313,5.284,3554750,68.9,64.8,2447579,2302450,145129,5.9
Washington,1990,1671815,98002,89810,5.372,28.727,16897,14.724,12272,10.694,117071,8580,8779,51087,107039,222904,329943,19.736,6.403,142681,240133,97452,14.364,5.829,3676359,68.6,65.1,2522048,2392468,129580,5.1
Washington,1991,1727258,99813,17682,1.024,33.484,17002,14.312,13326,11.218,120633,9103,9280,58924,122532,184329,306861,17.766,7.094,198513,289179,90666,16.742,5.249,3762333,68,63.9,2558726,2402722,156004,6.1
Washington,1992,1760079,102516,57294,3.255,32.566,16848,13.793,13515,11.065,123813,8728,8890,49827,123292,220592,343884,19.538,7.005,173519,286590,113071,16.283,6.424,3857918,68.6,63.7,2646459,2456125,190334,7.2
Washington,1993,1802062,105885,23864,1.324,31.108,16670,13.295,13520,10.783,126956,8805,9070,45793,98382,205775,304157,16.878,5.459,185578,280293,94715,15.554,5.256,3954336,68.3,63.3,2699901,2503525,196376,7.3
Washington,1994,1862500,109122,36327,1.95,28.82,17359,13.464,13763,10.675,130728,9382,9585,46256,107273,197436,304709,16.36,5.76,189162,268382,79220,14.41,4.253,4036254,67.9,63.6,2741491,2568913,172578,6.3
Washington,1995,1906451,111370,53712,2.817,27.368,17552,13.284,14721,11.142,133541,10153,10363,54880,115996,198597,314593,16.501,6.084,169488,260881,91393,13.684,4.794,4118590,68.1,63.8,2803674,2628791,174883,6.2
Washington,1996,1932330,112861,41746,2.16,28.055,18227,13.546,15057,11.19,136141,10545,10784,58103,118664,194136,312800,16.188,6.141,183493,271054,87561,14.027,4.531,4193091,69,64.9,2893865,2722664,171201,5.9
Washington,1997,1967129,114667,68527,3.484,31.943,18887,13.773,17002,12.398,138072,10759,10993,61717,134126,248584,382710,19.455,6.818,192339,314183,121844,15.972,6.194,4273176,69.5,66.1,2969804,2823819,145985,4.9
Washington,1998,2059467,117310,63237,3.071,28.219,17945,12.819,15144,10.818,141392,10072,10240,53976,116793,237025,353818,17.18,5.671,193447,290581,97134,14.11,4.716,4348345,69.7,66.4,3031932,2885396,146536,4.8
Washington,1999,2121799,118080,57134,2.693,28.999,17317,12.188,16002,11.263,142736,10610,11017,60048,133966,230815,364781,17.192,6.314,198876,307647,108771,14.499,5.126,4409013,69.5,66.1,3062751,2915510,147241,4.8
Washington,2000,2199893,118711,66783,3.036,28.875,17021,11.87,15842,11.048,143985,10468,10827,56210,126754,257633,384387,17.473,5.762,216211,317604,101393,14.437,4.609,4465692,69.1,65.6,3087680,2929824,157856,5.1
Washington,2001,2241201,118973,16647,0.743,30.463,17171,11.891,16369,11.336,144800,10305,10579,59122,124875,233146,358021,15.975,5.572,226704,341374,114670,15.232,5.116,4534286,68.1,64,3085655,2900354,185301,6
Washington,2002,2209078,118398,-101589,-4.599,31.058,18214,12.536,18011,12.396,145397,10953,11201,74435,140607,202436,343043,15.529,6.365,304439,444632,140193,20.127,6.346,4601381,67.4,62.6,3101001,2881326,219675,7.1
Washington,2003,2194735,120240,19417,0.885,30.525,17971,12.291,16257,11.119,147065,10082,10240,49221,114986,239397,354383,16.147,5.239,220152,334966,114814,15.262,5.231,4660988,67.3,62.4,3136253,2910008,226245,7.2
Washington,2004,2230462,122869,48644,2.181,25.684,18362,12.346,15115,10.163,150347,9784,9967,50299,109393,225685,335078,15.023,4.904,195071,286434,91363,12.842,4.096,4737670,67.3,63.1,3189389,2988316,201073,6.3
Washington,2005,2286878,126371,63251,2.766,26.491,19798,12.991,15713,10.311,154437,10067,10284,51188,125385,240774,366159,16.011,5.483,199911,302908,102997,13.245,4.504,4817314,67.7,63.9,3259772,3077058,182714,5.6
Washington,2006,2368596,130206,90974,3.841,26.159,21630,13.765,16222,10.323,159846,11097,11260,53216,141070,259704,400774,16.92,5.956,214529,309800,95271,13.079,4.022,4915790,67.7,64.4,3330058,3164354,165704,5
Washington,2007,2451976,132949,80143,3.269,26.126,20903,12.94,17393,10.767,163294,11275,11387,56361,126232,274215,400447,16.332,5.148,213614,320304,106690,13.063,4.351,5005665,68,64.8,3401404,3244794,156610,4.6
Washington,2008,2501054,132946,20771,0.83,27.013,18671,11.42,18082,11.059,163794,12140,12358,62219,111211,247361,358572,14.337,4.447,229165,337801,108636,13.506,4.344,5089154,68.3,64.7,3474043,3291664,182379,5.2
Washington,2009,2445696,127744,-141583,-5.789,24.717,15427,9.537,20701,12.797,159125,13625,13845,68324,97572,204680,302252,12.359,3.99,327991,443835,115844,18.148,4.737,5174102,66.9,61.4,3463713,3176729,286984,8.3
Washington,2010,2318051,126050,-58532,-2.525,23.995,16064,10.146,17744,11.207,157486,11326,11562,49884,105357,172756,278113,11.998,4.545,241964,336645,94681,14.523,4.085,5245864,65.9,59.9,3458451,3142109,316342,9.1
Washington,2011,2273887,124404,25259,1.111,24.775,16053,10.242,17513,11.173,156010,11144,11483,49567,92257,214682,306939,13.498,4.057,196119,281680,85561,12.388,3.763,5311367,64.7,59.2,3437871,3144459,293412,8.5
Washington,2012,2301790,124677,33885,1.472,23.95,16091,10.312,15987,10.245,156100,9660,9856,46729,91593,217929,309522,13.447,3.979,191151,275637,84486,11.975,3.67,5380521,64.5,59.5,3468738,3203294,265444,7.7
Washington,2013,2373885,125974,71108,2.995,23.413,16718,10.66,15153,9.662,157612,9407,9548,44018,122866,226142,349008,14.702,5.176,182991,277900,94909,11.707,3.998,5441680,63.6,59.4,3460772,3230947,229825,6.6
Washington,2014,2444154,127767,69971,2.863,20.806,16604,10.456,14307,9.01,159942,9125,9272,41906,96888,227345,324233,13.266,3.964,171609,254262,82653,10.403,3.382,5522477,63.3,59.5,3495153,3287904,207249,5.9
Washington,2015,2515626,130122,80104,3.184,21.19,17592,10.883,14194,8.781,163349,9298,9443,44945,115152,231478,346630,13.779,4.577,189169,266526,77357,10.595,3.075,5619383,63.3,59.8,3554826,3361249,193577,5.4
Washington,2016,2568129,132389,85156,3.316,20.47,17807,10.793,14498,8.787,166642,9542,9657,48398,112924,235081,348005,13.551,4.397,174917,262849,87932,10.235,3.424,5731878,63.7,60.4,3648558,3459527,189031,5.2
Washington,2017,2646258,134333,77028,2.911,22.508,17788,10.599,15369,9.158,169032,9692,9813,50797,102913,271919,374832,14.165,3.889,202447,297804,95357,11.254,3.603,5851092,63.7,60.8,3727683,3554754,172929,4.6
Washington,2018,2725664,136764,76567,2.809,21.638,17954,10.547,15523,9.119,171446,9998,10229,52536,116544,254917,371461,13.628,4.276,196145,294894,98749,10.819,3.623,5944441,64.2,61.3,3814538,3645992,168546,4.4
Washington,2019,2793520,138177,58363,2.089,20.861,17735,10.283,15696,9.101,173491,10653,10817,54389,113716,236031,349747,12.52,4.071,196064,291384,95320,10.431,3.412,6029945,65.7,62.9,3960885,3794004,166881,4.2
Washington,2020,2850664,137683,52258,1.833,21.584,17559,10.118,17484,10.075,173583,11299,11463,54908,125125,234775,359900,12.625,4.389,204863,307642,102779,10.792,3.605,6104497,63.7,58.3,3891363,3560168,331195,8.5
Washington,2021,2810796,139325,-131015,-4.661,23.25,19709,11.303,18097,10.379,175172,11213,11502,54649,115432,211325,326757,11.625,4.107,342503,457772,115269,16.286,4.101,6146147,63,59.7,3869163,3667123,202040,5.2
Washington,2022,2807609,142043,130451,4.646,23.803,21155,11.986,18431,10.443,177853,12921,13159,57839,126516,338076,464592,16.548,4.506,215459,334141,118682,11.901,4.227,6203580,64,61.4,3969967,3806848,163119,4.1
West Virginia,1978,456002,26605,4416,0.968,30.879,4081,13.28,3523,11.464,31009,2339,2363,10495,23754,51067,74821,16.408,5.209,49472,70405,20933,15.44,4.591,1412667,52.1,48.8,735448,688764,46684,6.3
West Virginia,1979,478563,27665,42005,8.777,23.194,4484,14.174,3372,10.659,32191,2339,2361,10177,24786,72717,97503,20.374,5.179,36424,55498,19074,11.597,3.986,1430417,52.8,48.9,755637,700171,55466,7.3
West Virginia,1980,491802,27510,-15256,-3.102,27.079,3735,11.613,3784,11.766,32137,2766,2775,11715,23836,42751,66587,13.539,4.847,59163,81843,22680,16.641,4.612,1444250,53.3,47.9,770365,692508,77857,10.1
West Virginia,1981,485364,27227,-620,-0.128,27.798,3805,11.856,3852,12.002,32070,2856,2873,12971,26585,40876,67461,13.899,5.477,48223,68081,19858,14.027,4.091,1456000,53.3,47.7,776443,693944,82499,10.6
West Virginia,1982,479876,26551,-12885,-2.685,27.082,3548,11.149,4114,12.928,31540,2917,2948,12943,23046,41934,64980,13.541,4.802,56084,77865,21781,16.226,4.539,1463250,53.3,45.8,780252,670683,109569,14
West Virginia,1983,449648,26389,-38205,-8.497,25.53,3636,11.561,3799,12.079,31369,2610,2664,13606,24528,32869,57397,12.765,5.455,70385,95602,25217,21.262,5.608,1470333,51.9,42.9,762562,631004,131558,17.3
West Virginia,1984,436255,27500,11117,2.548,27.248,4655,14.569,3492,10.929,32534,2565,2610,12743,25422,45131,70553,16.172,5.827,36470,59436,22966,13.624,5.264,1468083,51.6,44.4,758186,651199,106987,14.1
West Virginia,1985,442223,27138,-198,-0.045,29.859,4187,12.946,4578,14.155,32147,3391,3449,17131,26840,39182,66022,14.93,6.069,40546,66220,25674,14.974,5.806,1462917,51.4,44.7,752488,653421,99067,13.2
West Virginia,1986,436872,27212,3508,0.803,31.69,3957,12.28,3804,11.805,32300,2657,2696,12677,29729,43001,72730,16.648,6.805,44156,69222,25066,15.845,5.738,1455667,51.3,45.1,746870,656873,89997,12
West Virginia,1987,445589,27342,3861,0.866,32.764,4244,13.058,3826,11.772,32709,2630,2649,13434,31358,45499,76857,17.248,7.037,47887,72996,25109,16.382,5.635,1449750,51.2,45.5,741846,660265,81581,11
West Virginia,1988,461367,28007,6798,1.473,30.734,4231,12.771,3472,10.48,33508,2389,2431,14189,30392,47304,77696,16.84,6.587,45925,70898,24973,15.367,5.413,1440583,51.4,46.3,740828,667193,73635,9.9
West Virginia,1989,469732,28339,8739,1.86,28.007,3949,11.691,3449,10.211,34028,2477,2518,14229,29617,44901,74518,15.864,6.305,42020,65779,23759,14.004,5.058,1431417,53.1,48.5,760691,694291,66400,8.7
West Virginia,1990,482948,28642,15457,3.201,25.506,3971,11.586,3507,10.233,34505,2575,2618,14136,27585,49463,77048,15.954,5.712,39807,61591,21784,12.753,4.511,1398424,55,50.3,769471,703120,66351,8.6
West Virginia,1991,488319,28511,-2693,-0.551,28.88,3891,11.244,3595,10.388,34754,2481,2521,14585,29005,41509,70514,14.44,5.94,50409,73207,22798,14.992,4.669,1408715,55.4,49.5,780574,697664,82910,10.6
West Virginia,1992,484296,28577,-3844,-0.794,29.686,3649,10.494,3500,10.065,34847,2219,2266,12132,24831,47054,71885,14.843,5.127,49031,75729,26698,15.637,5.513,1415983,55.6,49.4,787489,699043,88446,11.2
West Virginia,1993,488482,29162,12392,2.537,26.044,3713,10.571,3148,8.963,35406,2107,2145,11067,23611,52390,76001,15.559,4.834,42744,63609,20865,13.022,4.271,1426084,55,49.3,784095,703598,80497,10.3
West Virginia,1994,502787,29624,9392,1.868,25.466,3748,10.479,3144,8.79,36069,2217,2235,10690,24787,48626,73413,14.601,4.93,44239,64021,19782,12.733,3.934,1432102,55,50.1,787408,717787,69621,8.8
West Virginia,1995,518157,30308,18598,3.589,24.061,4003,10.971,3152,8.639,36911,2182,2207,11244,27089,53846,80935,15.62,5.228,41537,62337,20800,12.031,4.014,1434620,54.8,50.5,786498,723841,62657,8
West Virginia,1996,523672,30311,-3186,-0.608,28.417,3855,10.431,3522,9.53,37123,2433,2467,13015,28420,45985,74405,14.208,5.427,53952,77591,23639,14.817,4.514,1437388,55,50.8,790966,730389,60577,7.7
West Virginia,1997,529297,30461,11076,2.093,27.777,4082,10.937,3708,9.935,37509,2480,2544,12875,29916,54671,84587,15.981,5.652,49217,73511,24294,13.888,4.59,1436405,55.1,51.2,790866,735590,55276,7
West Virginia,1998,544262,30598,11152,2.049,26.889,3691,9.779,3421,9.063,37881,2283,2312,11318,31894,52432,84326,15.494,5.86,52443,73174,20731,13.445,3.809,1434423,55.4,51.7,795033,741971,53062,6.7
West Virginia,1999,545983,30520,-1168,-0.214,27.159,3571,9.441,3588,9.486,37817,2376,2439,12716,28667,45474,74141,13.579,5.251,49577,75309,25732,13.793,4.713,1432275,55.8,52.2,799252,747578,51674,6.5
West Virginia,2000,556782,30295,14018,2.518,23.183,3466,9.168,3543,9.372,37766,2285,2368,12300,26829,51728,78557,14.109,4.819,43961,64539,20578,11.591,3.696,1430170,55.9,52.8,799081,754457,44624,5.6
West Virginia,2001,559211,29667,-5502,-0.984,26.692,3234,8.645,3847,10.283,37103,2408,2462,11407,23664,50967,74631,13.346,4.232,52052,80133,28081,14.33,5.022,1426973,55.8,52.8,796596,753657,42939,5.4
West Virginia,2002,562887,29391,4683,0.832,30.188,3627,9.77,3839,10.341,37019,2348,2382,14278,28300,61344,89644,15.926,5.028,58221,84961,26740,15.094,4.751,1428455,55.9,52.3,798709,747040,51669,6.5
West Virginia,2003,564116,29226,-983,-0.174,27.942,3482,9.416,3508,9.486,36967,2178,2309,13716,29662,49151,78813,13.971,5.258,55638,79796,24158,14.145,4.282,1431582,55.3,51.7,791841,739896,51945,6.6
West Virginia,2004,565532,29554,4555,0.805,24.644,3587,9.645,3128,8.411,37418,2064,2120,10688,22685,51555,74240,13.127,4.011,45894,69685,23791,12.322,4.207,1432844,55.1,51.9,789527,743989,45538,5.8
West Virginia,2005,568366,29546,705,0.124,26.239,3617,9.649,3476,9.273,37556,2308,2335,10985,24257,51015,75272,13.244,4.268,52456,74567,22111,13.12,3.89,1435076,55.4,52.3,794557,751202,43355,5.5
West Virginia,2006,579898,29419,19146,3.302,23.453,3782,10.044,3599,9.558,37747,2471,2511,12023,30922,56225,87147,15.028,5.332,46968,68001,21033,11.726,3.627,1440091,55.9,53,804910,763325,41585,5.2
West Virginia,2007,584410,29186,-9105,-1.558,27.308,3498,9.283,3584,9.511,37639,2315,2355,14953,26408,53386,79794,13.654,4.519,60599,88899,28300,15.212,4.842,1444435,55.7,53,804305,765517,38788,4.8
West Virginia,2008,582464,28483,3675,0.631,25.251,2980,7.975,3500,9.367,37106,2374,2390,11402,21720,55494,77214,13.256,3.729,51950,73539,21589,12.626,3.706,1448678,55.7,53,806254,768294,37960,4.7
West Virginia,2009,581145,27862,-11505,-1.98,23.166,2782,7.523,3297,8.916,36722,2229,2264,12445,22120,45194,67314,11.583,3.806,58005,78819,20814,13.563,3.582,1453261,55.8,51.2,811270,743870,67400,8.3
West Virginia,2010,569644,27210,-11984,-2.104,22.401,2486,6.821,3052,8.374,36163,1937,2005,9840,20786,43017,63803,11.201,3.649,56360,75787,19427,13.304,3.41,1476457,54.9,50.1,810101,739891,70210,8.7
West Virginia,2011,567759,26737,7870,1.386,21.642,2769,7.685,3020,8.381,35908,1975,2038,11278,18063,51243,69306,12.207,3.181,44527,61436,16909,10.821,2.978,1486488,54.3,50,806568,743346,63222,7.8
West Virginia,2012,576689,26539,10924,1.894,21.682,2649,7.4,2863,7.997,35692,1733,1787,8730,18998,54444,73442,12.735,3.294,42630,62518,19888,10.841,3.449,1488022,54.3,50.4,808022,749587,58435,7.2
West Virginia,2013,578676,26029,-2930,-0.506,22.619,2537,7.158,2968,8.374,35227,1816,1838,9864,18303,47141,65444,11.309,3.163,44947,68374,23427,11.816,4.048,1487023,53.8,50.2,799481,745849,53632,6.7
West Virginia,2014,575162,25500,-3018,-0.525,22.15,2425,6.921,2829,8.074,34837,1774,1802,9243,20731,42968,63699,11.075,3.604,46200,66717,20517,11.6,3.567,1484923,53.6,50.1,795733,743955,51778,6.5
West Virginia,2015,571131,25260,-6366,-1.115,21.682,2639,7.585,2754,7.915,34735,1758,1790,9358,19107,42809,61916,10.841,3.345,49850,68282,18432,11.956,3.227,1480493,53.5,49.9,791526,739455,52071,6.6
West Virginia,2016,563829,24943,-7322,-1.299,21.758,2485,7.173,2666,7.695,34555,1774,1824,11275,18762,42577,61339,10.879,3.328,50422,68661,18239,12.178,3.235,1474040,53.3,50,785104,737205,47899,6.1
West Virginia,2017,553902,24530,-10360,-1.87,22.035,2491,7.256,2939,8.561,34105,1714,1745,8632,17660,43367,61027,11.018,3.188,50915,71387,20472,12.888,3.696,1467310,53.5,50.7,784744,743786,40958,5.2
West Virginia,2018,553335,24121,8277,1.496,21.972,2315,6.832,2742,8.092,33671,1710,1752,9983,20694,48372,69066,12.482,3.74,41300,60789,19489,10.986,3.522,1458977,54.4,51.6,793415,752602,40813,5.1
West Virginia,2019,556701,24039,-3012,-0.541,21.239,2490,7.394,2464,7.317,33689,1621,1646,11154,20128,38992,59120,10.62,3.616,41172,62132,20960,11.161,3.765,1452860,54.7,52,794874,755523,39351,5
West Virginia,2020,550429,23432,-10658,-1.936,19.078,2269,6.789,2801,8.381,33156,1722,1774,8572,17161,35343,52504,9.539,3.118,44691,63162,18471,11.475,3.356,1443575,53.8,49.4,777139,713044,64095,8.2
West Virginia,2021,533422,23141,-24242,-4.545,20.094,2629,7.961,2895,8.767,32889,1708,1773,10055,20030,33562,53592,10.047,3.755,56927,77834,20907,14.591,3.919,1438215,53.8,51,773616,733825,39791,5.1
West Virginia,2022,530967,23350,17588,3.312,21.265,2978,9.044,2885,8.761,32976,1713,1779,9070,22984,51059,74043,13.945,4.329,37575,56455,18880,10.632,3.556,1432000,54.4,52.3,778705,748269,30436,3.9
Wisconsin,1978,1490678,79024,119137,7.992,20.395,11929,13.339,8107,9.065,91339,5639,5687,30459,76516,194631,271147,18.19,5.133,96292,152010,55718,10.197,3.738,3366333,66.9,63.6,2252463,2142577,109886,4.9
Wisconsin,1979,1589291,81743,71386,4.492,21.649,10786,11.589,7850,8.434,94540,5534,5584,26275,70287,173134,243421,15.316,4.423,118572,172035,53463,10.825,3.364,3419750,67.6,64.5,2311082,2207045,104037,4.5
Wisconsin,1980,1619761,81926,-11366,-0.702,24.656,9582,10.109,9154,9.657,95004,6664,6738,32163,60526,139160,199686,12.328,3.737,154417,211052,56635,13.03,3.497,3474833,67.6,62.7,2349514,2177119,172395,7.3
Wisconsin,1981,1600139,82174,-26576,-1.661,24.619,9501,9.969,8720,9.149,95700,6368,6465,30427,75345,121628,196973,12.31,4.709,172687,223549,50862,13.971,3.179,3512917,67.6,62.3,2375413,2189577,185836,7.8
Wisconsin,1982,1568836,81248,-32166,-2.05,24.585,9494,9.938,9891,10.354,95334,7004,7082,32058,64527,128321,192848,12.292,4.113,168579,225014,56435,14.343,3.597,3535500,68.4,61.4,2418295,2169284,249011,10.3
Wisconsin,1983,1531874,82754,-43405,-2.833,25.868,10587,11.032,8874,9.247,96823,6101,6210,32622,70158,127971,198129,12.934,4.58,182035,241534,59499,15.767,3.884,3540083,68,61.3,2407826,2171820,236006,9.8
Wisconsin,1984,1555108,85544,92828,5.969,21.387,12131,12.326,9070,9.215,99952,6450,6543,32554,76891,182233,259124,16.663,4.944,108684,166296,57612,10.694,3.705,3555250,67.5,62.6,2399766,2225602,174164,7.3
Wisconsin,1985,1618711,85688,32958,2.036,25.428,11155,11.154,10982,10.981,100099,7949,8129,48655,76315,162445,238760,14.75,4.715,127393,205802,78409,12.714,4.844,3572500,67.1,62.3,2397272,2225867,171405,7.2
Wisconsin,1986,1639290,85844,10973,0.669,28.261,11318,11.282,10858,10.823,100550,7346,7465,49083,84235,158378,242613,14.8,5.139,138183,231640,93457,14.131,5.701,3591333,67.7,63.1,2431681,2267118,164563,6.8
Wisconsin,1987,1696775,87949,100381,5.916,24.776,13545,13.239,9940,9.715,104114,6943,7038,41633,138298,172277,310575,18.304,8.151,140003,210194,70191,12.388,4.137,3617667,68.9,64.9,2491219,2348503,142716,5.7
Wisconsin,1988,1788084,89450,76788,4.294,24.775,11978,11.373,9798,9.303,106412,6793,6910,42848,106926,191361,298287,16.682,5.98,142807,221499,78692,12.388,4.401,3649000,69.9,66.8,2549189,2437606,111583,4.4
Wisconsin,1989,1863404,90984,76286,4.094,23.048,12086,11.234,9808,9.117,108722,6844,7037,39045,90123,200901,291024,15.618,4.836,141617,214738,73121,11.524,3.924,3669500,70.7,67.7,2593909,2482942,110967,4.3
Wisconsin,1990,1935673,92839,64403,3.327,21.959,11686,10.626,9256,8.416,111191,6654,6846,39393,93647,183279,276926,14.306,4.838,146243,212523,66280,10.979,3.424,3677217,70.7,67.6,2599064,2485724,113340,4.4
Wisconsin,1991,1958612,93007,-17355,-0.886,25.835,11950,10.672,10059,8.983,112919,7074,7267,58224,89670,163333,253003,12.917,4.578,180359,270358,89999,13.804,4.595,3720427,70.7,66.9,2629585,2487850,141735,5.4
Wisconsin,1992,1962163,93581,33746,1.72,23.723,10967,9.68,9972,8.802,113794,6572,6682,37733,80107,186382,266489,13.581,4.083,163070,232743,69673,11.862,3.551,3766809,71.6,67.9,2696490,2559155,137335,5.1
Wisconsin,1993,2006314,95764,57290,2.855,22.281,11424,9.941,9185,7.992,116043,6271,6449,36526,81479,199329,280808,13.996,4.061,151882,223518,71636,11.141,3.571,3817858,72,68.8,2747727,2628338,119389,4.3
Wisconsin,1994,2072904,97352,53148,2.564,21.414,11593,9.884,9547,8.14,118310,6668,6842,38350,86860,188229,275089,13.271,4.19,153334,221941,68607,10.707,3.31,3860824,73.1,70,2821562,2702367,119195,4.2
Wisconsin,1995,2138584,99111,83299,3.895,20.092,11910,9.971,9603,8.04,120601,6818,7025,37889,95806,202336,298142,13.941,4.48,150645,214843,64198,10.046,3.002,3908123,73.5,70.7,2871308,2764753,106555,3.7
Wisconsin,1996,2177022,99766,33113,1.521,21.875,11686,9.661,9899,8.183,121857,7055,7203,38549,86874,184354,271228,12.459,3.99,170422,238115,67693,10.938,3.109,3954173,73.9,71.2,2920463,2815515,104948,3.6
Wisconsin,1997,2227400,100703,48477,2.176,24.645,12231,9.983,10992,8.972,123140,7228,7459,45947,105976,216970,322946,14.499,4.758,182518,274469,91951,12.322,4.128,3987222,74.1,71.5,2955752,2852665,103087,3.5
Wisconsin,1998,2292899,102093,52143,2.274,22.759,11602,9.339,10266,8.263,124906,6770,6945,41218,93171,219890,313061,13.654,4.063,176272,260918,84646,11.379,3.692,4014688,73.9,71.4,2965939,2868464,97475,3.3
Wisconsin,1999,2338122,102422,38196,1.634,23.419,11286,8.998,10355,8.256,125889,6946,7146,43396,93773,218203,311976,13.343,4.011,187641,273780,86139,11.709,3.684,4047570,73.1,70.8,2958137,2867200,90937,3.1
Wisconsin,2000,2388054,102638,58039,2.43,22.611,11494,9.087,10418,8.236,127033,6959,7155,40720,104751,223265,328016,13.736,4.386,182508,269977,87469,11.305,3.663,4086373,73.1,70.6,2985643,2884737,100906,3.4
Wisconsin,2001,2400454,102367,-31321,-1.305,23.608,11123,8.757,11092,8.733,127034,7057,7395,46755,90058,193286,283344,11.804,3.752,214189,314665,100476,13.109,4.186,4127721,73.1,69.9,3017681,2884305,133376,4.4
Wisconsin,2002,2383655,102078,-40318,-1.691,28.089,12798,10.038,12580,9.867,127600,7551,7759,56668,131469,203299,334768,14.044,5.515,262463,375086,112623,15.736,4.725,4170446,72.3,68.5,3016760,2856234,160526,5.3
Wisconsin,2003,2374777,102099,24321,1.024,24.673,11749,9.201,11450,8.967,127845,7188,7306,40303,103960,213325,317285,13.361,4.378,204128,292964,88836,12.336,3.741,4210386,72.3,68.3,3045298,2873956,171342,5.6
Wisconsin,2004,2409921,103191,48977,2.032,22.069,11778,9.159,10292,8.004,129336,6691,6917,40361,97395,217499,314894,13.067,4.041,179106,265917,86811,11.034,3.602,4247547,71.4,67.9,3034621,2883573,151048,5
Wisconsin,2005,2435900,104216,15316,0.629,23.744,12204,9.382,10726,8.246,130820,7090,7285,43406,97666,206845,304511,12.501,4.009,198890,289195,90305,11.872,3.707,4285261,70.7,67.3,3029662,2885671,143991,4.8
Wisconsin,2006,2465174,104409,28642,1.162,22.975,13438,10.21,11848,9.002,132409,8146,8283,44187,109228,202606,311834,12.65,4.431,201917,283192,81275,11.488,3.297,4323865,70.9,67.6,3066266,2923575,142691,4.7
Wisconsin,2007,2479804,104159,477,0.019,24.782,12557,9.482,12418,9.377,132505,7815,7947,43364,100349,207400,307749,12.41,4.047,211596,307272,95676,12.391,3.858,4358161,70.8,67.4,3087598,2938876,148722,4.8
Wisconsin,2008,2480645,102447,1949,0.079,23.04,10889,8.262,12183,9.244,131149,8046,8211,46922,85880,201842,287722,11.599,3.462,196346,285773,89427,11.52,3.605,4388989,70.6,67.1,3098931,2945874,153057,4.9
Wisconsin,2009,2418761,99915,-134966,-5.58,17.737,9758,7.497,12531,9.628,128765,8097,8254,54535,70019,144489,214508,8.869,2.895,250409,349474,99065,14.448,4.096,4417134,70.5,64.1,3112494,2833292,279202,9
Wisconsin,2010,2335340,98329,-31970,-1.369,20.023,9529,7.441,10981,8.575,127335,6874,7063,35280,78810,154992,233802,10.011,3.375,194340,265772,71432,11.38,3.059,4435706,69.5,63.6,3082935,2820620,262315,8.5
Wisconsin,2011,2335955,97032,32951,1.411,18.905,9501,7.495,10629,8.384,126206,6689,6921,35183,63349,190408,253757,10.863,2.712,159047,220806,61759,9.452,2.644,4457584,68.9,63.7,3072157,2839987,232170,7.6
Wisconsin,2012,2370061,96794,32722,1.381,19.68,10017,7.942,10119,8.023,126079,6177,6356,35197,70275,195665,265940,11.221,2.965,164773,233218,68445,9.84,2.888,4480828,68.5,63.8,3070033,2857150,212883,6.9
Wisconsin,2013,2398349,96141,25071,1.045,19.482,9642,7.663,10081,8.012,125605,6057,6161,34219,67718,190971,258689,10.786,2.824,165342,233618,68276,9.741,2.847,4504761,68.3,63.8,3077801,2871988,205813,6.7
Wisconsin,2014,2414980,96185,50264,2.081,17.266,9755,7.748,9225,7.327,126164,5815,5943,30985,72209,186543,258752,10.714,2.99,148441,208488,60047,8.633,2.486,4526945,68,64.4,3077981,2913764,164217,5.3
Wisconsin,2015,2466927,96693,54066,2.192,17.886,10246,8.082,9031,7.123,127387,5786,5891,33400,77384,197296,274680,11.135,3.137,160748,220614,59866,8.943,2.427,4545552,67.9,64.8,3084207,2947048,137159,4.4
Wisconsin,2016,2507558,97720,28124,1.122,19.832,11407,8.865,8854,6.881,129950,5743,5872,33595,90799,185969,276768,11.037,3.621,181756,248644,66888,9.916,2.667,4566315,68.1,65.5,3110466,2988744,121722,3.9
Wisconsin,2017,2530752,97448,30467,1.204,21.517,9986,7.688,10103,7.779,129825,6106,6250,36493,88315,214417,302732,11.962,3.49,185059,272265,87206,10.758,3.446,4617621,68,65.8,3141757,3039348,102409,3.3
Wisconsin,2018,2577790,97547,38718,1.502,19.488,9626,7.423,9742,7.512,129620,5994,6186,34193,79434,210470,289904,11.246,3.081,174122,251186,77064,9.744,2.99,4643524,67.3,65.3,3123898,3030659,93239,3
Wisconsin,2019,2602047,97533,12188,0.468,20.355,9917,7.63,9221,7.094,130328,6139,6277,41631,90809,186203,277012,10.646,3.49,192930,264824,71894,10.178,2.763,4670191,66.8,64.6,3117744,3017904,99840,3.2
Wisconsin,2020,2604414,97042,-5517,-0.212,20.612,9736,7.479,10000,7.682,130047,6246,6436,39141,75434,192971,268405,10.306,2.896,191303,273922,82619,10.518,3.172,4692208,66.1,61.8,3100674,2900956,199718,6.4
Wisconsin,2021,2561769,97010,-79482,-3.103,20.449,10821,8.316,10659,8.191,130209,6353,6565,36884,79496,182430,261926,10.224,3.103,263790,341408,77618,13.327,3.03,4701872,66.1,63.5,3106511,2986636,119875,3.9
Wisconsin,2022,2557709,97801,72867,2.849,22.323,11722,8.978,10958,8.393,130944,6960,7307,42151,90814,267534,358348,14.011,3.551,198090,285481,87391,11.162,3.417,4725715,65.5,63.6,3094981,3004778,90203,2.9
Wyoming,1978,120984,10503,22341,18.466,32.003,2309,20.498,1396,12.393,11721,979,991,4529,15339,26361,41700,34.467,12.679,11189,19359,8170,16.001,6.753,304250,69.1,67.1,210275,204273,6002,2.9
Wyoming,1979,138795,11085,11772,8.482,34.3,2154,17.822,1508,12.477,12409,1095,1101,5758,13973,21602,35575,25.631,10.067,15528,23803,8275,17.15,5.962,319667,69.8,68.1,223199,217637,5562,2.5
Wyoming,1980,148813,11459,7831,5.262,34.634,2065,16.33,1612,12.748,12872,1161,1179,6441,12787,20814,33601,22.579,8.593,16538,25770,9232,17.317,6.204,335333,70.2,67.5,235508,226513,8995,3.8
Wyoming,1981,156951,11757,8861,5.646,34.626,2087,15.96,1646,12.587,13297,1231,1236,5829,12003,24031,36034,22.959,7.648,18486,27173,8687,17.313,5.535,348250,71,68.1,247284,237060,10224,4.1
Wyoming,1982,160516,11857,-1893,-1.179,40.522,2167,16.134,1894,14.101,13568,1416,1424,7112,12516,20006,32522,20.261,7.797,23392,34415,11023,21.44,6.867,358000,70.7,66.5,253139,238116,15023,5.9
Wyoming,1983,149367,11827,-19785,-13.246,33.813,1945,14.362,1973,14.568,13529,1417,1436,7689,11144,14109,25253,16.907,7.461,32626,45038,12412,30.153,8.31,363083,70.8,65.1,256895,236420,20475,8
Wyoming,1984,139362,11945,-446,-0.32,40.347,1929,14.18,1784,13.114,13676,1240,1252,5667,13053,15061,28114,20.173,9.366,18432,28560,10128,20.493,7.267,361833,70.4,66,254894,238808,16086,6.3
Wyoming,1985,138962,11894,59,0.042,38.108,1882,13.806,1963,14.4,13591,1369,1380,6229,10567,15970,26537,19.097,7.604,16043,26478,10435,19.054,7.509,358083,70.9,65.9,253769,236011,17758,7
Wyoming,1986,137403,11572,-5158,-3.754,35.055,1692,12.586,1990,14.802,13295,1430,1445,6943,10187,13896,24083,17.527,7.414,18572,29241,10669,21.281,7.765,358417,70.1,64.1,251398,229768,21630,8.6
Wyoming,1987,131617,11098,-10635,-8.08,30.297,1575,12.081,2124,16.293,12762,1435,1456,6667,8738,11200,19938,15.148,6.639,19183,30573,11390,23.229,8.654,349500,69.5,63.9,243015,223403,19612,8.1
Wyoming,1988,123926,11141,-548,-0.442,37.422,1652,12.918,1610,12.59,12809,1061,1074,5502,8839,14349,23188,18.711,7.133,13682,23736,10054,19.153,8.113,345500,69.2,64.7,239015,223576,15439,6.5
Wyoming,1989,125624,11168,2442,1.944,32.281,1578,12.302,1548,12.068,12842,1043,1055,4744,7898,14820,22718,18.084,6.287,12592,20276,7684,16.14,6.117,344000,69.4,65.1,238603,224022,14581,6.1
Wyoming,1990,130241,11302,6285,4.826,28.228,1544,11.952,1382,10.698,12999,957,972,4547,8107,16560,24667,18.94,6.225,11533,18382,6849,14.114,5.259,329521,72,68.3,237162,225092,12070,5.1
Wyoming,1991,135770,11488,2927,2.156,30.513,1644,12.49,1309,9.945,13330,928,934,5177,8072,15569,23641,17.413,5.945,13531,20714,7183,15.257,5.291,333564,71,67.5,236766,225041,11725,5
Wyoming,1992,137603,11619,1517,1.102,32.043,1552,11.607,1441,10.777,13427,850,877,3818,7431,16132,23563,17.124,5.4,14871,22046,7175,16.021,5.214,339655,70.4,66.6,239214,226241,12973,5.4
Wyoming,1993,140203,12027,3702,2.64,30.934,1850,13.501,1285,9.378,13985,841,859,4058,9861,15526,25387,18.107,7.033,14541,21685,7144,15.467,5.095,346080,70.3,66.6,243346,230438,12908,5.3
Wyoming,1994,146803,12534,7986,5.44,26.796,1831,12.8,1264,8.836,14588,839,857,3572,10967,16688,27655,18.838,7.471,13920,19669,5749,13.398,3.916,352921,70.8,67.3,249817,237595,12222,4.9
Wyoming,1995,157439,12904,-7999,-5.081,31.286,1770,11.977,1388,9.392,14969,950,962,4339,8799,15829,24628,15.643,5.589,25490,32627,7137,20.724,4.533,358595,70.6,67.2,253214,241060,12154,4.8
Wyoming,1996,152191,13123,675,0.444,29.379,1827,12.132,1508,10.014,15219,1059,1090,4507,8377,14654,23031,15.133,5.504,15933,22356,6423,14.689,4.22,363019,70.3,66.8,255091,242327,12764,5
Wyoming,1997,153863,13247,2977,1.935,33.423,1792,11.783,1814,11.928,15197,1056,1067,4596,9439,19251,28690,18.646,6.135,14933,25713,10780,16.712,7.006,365527,70.1,66.7,256151,243944,12207,4.8
Wyoming,1998,162308,13596,4289,2.643,30.569,1829,11.843,1480,9.583,15618,1023,1039,4615,10630,18467,29097,17.927,6.549,15896,24808,8912,15.285,5.491,366952,70.9,67.5,260273,247839,12434,4.8
Wyoming,1999,166742,13558,4185,2.51,29.396,1749,11.176,1690,10.799,15679,1143,1152,4690,9556,19137,28693,17.208,5.731,15768,24508,8740,14.698,5.242,369959,71.3,67.9,263801,251344,12457,4.7
Wyoming,2000,171955,13707,5998,3.488,26.968,1676,10.622,1499,9.5,15867,973,997,4402,9050,20134,29184,16.972,5.263,15671,23186,7515,13.484,4.37,372818,71.3,68.6,265701,255726,9975,3.8
Wyoming,2001,176800,13845,3551,2.008,28.713,1808,11.332,1660,10.404,16029,1038,1055,4872,9986,18947,28933,16.365,5.648,16618,25382,8764,14.356,4.957,375043,71.6,68.8,268393,258172,10221,3.8
Wyoming,2002,178192,14133,167,0.094,37.644,2053,12.65,1741,10.728,16385,1051,1062,5715,13570,20136,33706,18.916,7.615,21246,33539,12293,18.822,6.899,379314,71,68.2,269405,258571,10834,4
Wyoming,2003,180260,14345,3944,2.188,30.354,1890,11.461,1678,10.175,16597,1061,1082,5132,9923,21379,31302,17.365,5.505,17967,27358,9391,15.177,5.21,382581,71.3,68.2,272804,260995,11809,4.3
Wyoming,2004,185294,14652,6947,3.749,25.842,1915,11.42,1572,9.374,16941,986,992,4407,9571,21318,30889,16.67,5.165,15400,23942,8542,12.921,4.61,386204,71.1,68.4,274736,264187,10549,3.8
Wyoming,2005,192090,15003,4692,2.443,27.876,2064,12.014,1589,9.249,17418,1103,1111,5165,10889,20576,31465,16.38,5.669,18661,26773,8112,13.938,4.223,389945,71.6,69,279083,269172,9911,3.6
Wyoming,2006,201273,15428,10864,5.398,25.642,2307,13.058,1804,10.211,17919,1196,1208,5448,12443,24226,36669,18.219,6.182,17213,25805,8592,12.821,4.269,396036,71.9,69.8,284826,276310,8516,3
Wyoming,2007,211298,15772,8817,4.173,27.594,2232,12.311,1751,9.658,18371,1163,1188,5303,11708,26262,37970,17.97,5.541,19746,29153,9407,13.797,4.452,403554,72,70.1,290748,283072,7676,2.6
Wyoming,2008,217511,15849,6334,2.912,29.841,2045,11.104,1918,10.414,18481,1230,1244,5861,12192,26596,38788,17.833,5.605,21758,32454,10696,14.921,4.917,410860,72.2,70.1,296620,287909,8711,2.9
Wyoming,2009,216245,15729,-7556,-3.494,26.25,1795,9.717,1947,10.54,18397,1322,1346,6396,8574,19808,28382,13.125,3.965,25977,35938,9961,16.619,4.606,418116,71.7,67.2,299893,281123,18770,6.3
Wyoming,2010,207135,15322,-8677,-4.189,23.573,1540,8.458,1924,10.567,18016,1227,1245,4952,7827,16587,24414,11.787,3.779,24992,33091,8099,15.976,3.91,430897,70.1,65.2,301893,280953,20940,6.9
Wyoming,2011,204381,15411,2861,1.4,25.967,1863,10.295,1707,9.433,18174,1089,1099,4569,8500,20897,29397,14.383,4.159,18418,26536,8118,12.984,3.972,437132,69.3,65,302932,284273,18659,6.2
Wyoming,2012,210095,15574,5836,2.778,25.218,1864,10.206,1680,9.198,18356,1074,1106,5492,9982,22345,32327,15.387,4.751,16784,26491,9707,12.609,4.62,443928,68.4,64.7,303748,287110,16638,5.5
Wyoming,2013,213143,15518,737,0.346,26.247,1763,9.605,1742,9.491,18365,1123,1135,5161,10441,18268,28709,13.469,4.899,18708,27972,9264,13.124,4.346,448554,67.4,64.2,302201,287792,14409,4.8
Wyoming,2014,216399,15561,5996,2.771,22.813,1715,9.309,1591,8.635,18486,1050,1053,3631,8975,21705,30680,14.178,4.147,16938,24684,7746,11.407,3.58,449700,67.3,64.4,302865,289694,13171,4.3
Wyoming,2015,219696,15800,1137,0.518,25.356,1827,9.812,1578,8.475,18745,1041,1046,3881,9435,19555,28990,13.196,4.295,19935,27853,7918,12.678,3.604,451235,66.8,64,301608,288894,12714,4.2
Wyoming,2016,214611,15602,-11293,-5.262,22.135,1791,9.577,1874,10.021,18659,1314,1325,6648,9324,14428,23752,11.067,4.345,25129,35045,9916,16.33,4.62,450992,66.6,63.1,300546,284439,16107,5.4
Wyoming,2017,205116,15579,-6373,-3.107,25.416,1817,9.762,1902,10.219,18570,1149,1177,4789,9499,16567,26066,12.708,4.631,21850,32439,10589,15.815,5.162,445796,65.9,63.1,293802,281164,12638,4.3
Wyoming,2018,206372,15764,4334,2.1,23.648,1914,10.275,1790,9.61,18689,1151,1185,5194,9431,19304,28735,13.924,4.57,15477,24401,8924,11.824,4.324,445661,65.7,63,292629,280754,11875,4.1
Wyoming,2019,209765,15896,1776,0.847,20.921,1897,10.104,1715,9.134,18866,1180,1191,4588,8060,15658,23718,11.307,3.842,14970,21942,6972,10.46,3.324,447440,65.7,63.3,293997,283071,10926,3.7
Wyoming,2020,209613,16087,172,0.082,23.915,2099,11.072,1916,10.106,19050,1263,1294,4971,10099,15137,25236,12.039,4.818,15134,25064,9930,11.957,4.737,449818,65.3,61.4,293606,276367,17239,5.9
Wyoming,2021,204655,16530,-9956,-4.865,23.715,2313,11.996,1849,9.589,19514,1217,1244,4929,10389,13878,24267,11.858,5.076,24828,34223,9395,16.722,4.591,453174,63.7,60.8,288769,275633,13136,4.5
Wyoming,2022,203877,16856,8163,4.004,25.421,2482,12.596,2084,10.577,19903,1543,1565,7058,12266,21811,34077,16.714,6.016,15392,25914,10522,12.711,5.161,457197,64,61.8,292664,282615,10049,3.4